"country","region","region_code","start_date","end_date","days","year","week","population","total_deaths","covid_deaths","expected_deaths","excess_deaths","non_covid_deaths","covid_deaths_per_100k","excess_deaths_per_100k","excess_deaths_pct_change"
"United States","Alabama","AL",2019-12-29,2020-01-04,7,2020,"1",4903185,1082,0,1155,-73,1082,0,-1.48882818005031,-0.0632034632034632
"United States","Alabama","AL",2020-01-05,2020-01-11,7,2020,"2",4903185,1127,0,1172,-45,1127,0,-0.917770795921427,-0.03839590443686
"United States","Alabama","AL",2020-01-12,2020-01-18,7,2020,"3",4903185,1039,0,1153,-114,1039,0,-2.32501934966761,-0.0988725065047702
"United States","Alabama","AL",2020-01-19,2020-01-25,7,2020,"4",4903185,1056,0,1138,-82,1056,0,-1.6723823392346,-0.0720562390158173
"United States","Alabama","AL",2020-01-26,2020-02-01,7,2020,"5",4903185,1026,0,1136,-110,1026,0,-2.24343972336349,-0.096830985915493
"United States","Alabama","AL",2020-02-02,2020-02-08,7,2020,"6",4903185,1120,0,1152,-32,1120,0,-0.652637010433014,-0.0277777777777778
"United States","Alabama","AL",2020-02-09,2020-02-15,7,2020,"7",4903185,1095,0,1144,-49,1095,0,-0.999350422225553,-0.0428321678321678
"United States","Alabama","AL",2020-02-16,2020-02-22,7,2020,"8",4903185,1098,0,1129,-31,1098,0,-0.632242103856983,-0.0274579273693534
"United States","Alabama","AL",2020-02-23,2020-02-29,7,2020,"9",4903185,1164,0,1108,56,1164,0,1.14211476825778,0.0505415162454874
"United States","Alabama","AL",2020-03-01,2020-03-07,7,2020,"10",4903185,1057,0,1105,-48,1057,0,-0.978955515649522,-0.0434389140271493
"United States","Alabama","AL",2020-03-08,2020-03-14,7,2020,"11",4903185,1091,0,1096,-5,1091,0,-0.101974532880159,-0.00456204379562042
"United States","Alabama","AL",2020-03-15,2020-03-21,7,2020,"12",4903185,1059,0,1091,-32,1059,0,-0.652637010433014,-0.0293308890925756
"United States","Alabama","AL",2020-03-22,2020-03-28,7,2020,"13",4903185,1073,3,1081,-8,1070,0.0611847197280951,-0.163159252608254,-0.00740055504162818
"United States","Alabama","AL",2020-03-29,2020-04-04,7,2020,"14",4903185,1156,23,1062,94,1133,0.469082851248729,1.91712121814698,0.088512241054614
"United States","Alabama","AL",2020-04-05,2020-04-11,7,2020,"15",4903185,1135,34,1049,86,1101,0.693426823585078,1.75396196553873,0.0819828408007626
"United States","Alabama","AL",2020-04-12,2020-04-18,7,2020,"16",4903185,1149,50,1051,98,1099,1.01974532880158,1.99870084445111,0.093244529019981
"United States","Alabama","AL",2020-04-19,2020-04-25,7,2020,"17",4903185,1139,102,1043,96,1037,2.08028047075523,1.95791103129904,0.0920421860019176
"United States","Alabama","AL",2020-04-26,2020-05-02,7,2020,"18",4903185,1147,75,1037,110,1072,1.52961799320238,2.24343972336349,0.106075216972035
"United States","Alabama","AL",2020-05-03,2020-05-09,7,2020,"19",4903185,1171,101,1019,152,1070,2.0598855641792,3.10002579955682,0.149165848871443
"United States","Alabama","AL",2020-05-10,2020-05-16,7,2020,"20",4903185,1148,94,1016,132,1054,1.91712121814698,2.69212766803618,0.12992125984252
"United States","Alabama","AL",2020-05-17,2020-05-23,7,2020,"21",4903185,1153,69,1013,140,1084,1.40724855374619,2.85528692064444,0.138203356367226
"United States","Alabama","AL",2020-05-24,2020-05-30,7,2020,"22",4903185,1109,67,1020,89,1042,1.36645874059412,1.81514668526682,0.0872549019607842
"United States","Alabama","AL",2020-05-31,2020-06-06,7,2020,"23",4903185,1173,66,993,180,1107,1.34606383401809,3.67108318368571,0.181268882175227
"United States","Alabama","AL",2020-06-07,2020-06-13,7,2020,"24",4903185,1138,84,987,151,1054,1.71317215238666,3.07963089298079,0.152988855116515
"United States","Alabama","AL",2020-06-14,2020-06-20,7,2020,"25",4903185,1090,70,976,114,1020,1.42764346032222,2.32501934966761,0.116803278688525
"United States","Alabama","AL",2020-06-21,2020-06-27,7,2020,"26",4903185,1151,81,978,173,1070,1.65198743265857,3.52831883765348,0.176891615541922
"United States","Alabama","AL",2020-06-28,2020-07-04,7,2020,"27",4903185,1201,88,982,219,1113,1.79475177869079,4.46648454015094,0.223014256619145
"United States","Alabama","AL",2020-07-05,2020-07-11,7,2020,"28",4903185,1265,107,978,287,1158,2.18225500363539,5.8533381873211,0.293456032719836
"United States","Alabama","AL",2020-07-12,2020-07-18,7,2020,"29",4903185,1289,172,971,318,1117,3.50792393107745,6.48558029117808,0.327497425334706
"United States","Alabama","AL",2020-07-19,2020-07-25,7,2020,"30",4903185,1333,170,965,368,1163,3.46713411792539,7.50532561997967,0.381347150259067
"United States","Alabama","AL",2020-07-26,2020-08-01,7,2020,"31",4903185,1364,147,958,406,1217,2.99805126667666,8.28033206986887,0.423799582463465
"United States","Alabama","AL",2020-08-02,2020-08-08,7,2020,"32",4903185,1379,165,957,422,1214,3.36515958504523,8.60665057508538,0.440961337513062
"United States","Alabama","AL",2020-08-09,2020-08-15,7,2020,"33",4903185,1305,128,955,350,1177,2.61054804173206,7.1382173016111,0.366492146596859
"United States","Alabama","AL",2020-08-16,2020-08-22,7,2020,"34",4903185,1303,115,955,348,1188,2.34541425624365,7.09742748845903,0.364397905759162
"United States","Alabama","AL",2020-08-23,2020-08-29,7,2020,"35",4903185,1216,141,949,267,1075,2.87568182722047,5.44544005580046,0.281348788198103
"United States","Alabama","AL",2020-08-30,2020-09-05,7,2020,"36",4903185,1216,123,956,260,1093,2.5085735088519,5.30267570976824,0.271966527196653
"United States","Alabama","AL",2020-09-06,2020-09-12,7,2020,"37",4903185,1232,75,966,266,1157,1.52961799320238,5.42504514922443,0.27536231884058
"United States","Alabama","AL",2020-09-13,2020-09-19,7,2020,"38",4903185,1200,87,975,225,1113,1.77435687211476,4.58885397960713,0.230769230769231
"United States","Alabama","AL",2020-09-20,2020-09-26,7,2020,"39",4903185,1183,64,974,209,1119,1.30527402086603,4.26253547439063,0.214579055441478
"United States","Alabama","AL",2020-09-27,2020-10-03,7,2020,"40",4903185,1103,57,983,120,1046,1.16250967483381,2.4473887891238,0.12207527975585
"United States","Alabama","AL",2020-10-04,2020-10-10,7,2020,"41",4903185,1204,106,981,223,1098,2.16186009705936,4.54806416645507,0.227319062181448
"United States","Alabama","AL",2020-10-11,2020-10-17,7,2020,"42",4903185,1190,124,971,219,1066,2.52896841542793,4.46648454015094,0.225540679711637
"United States","Alabama","AL",2020-10-18,2020-10-24,7,2020,"43",4903185,1142,78,972,170,1064,1.59080271293047,3.46713411792539,0.174897119341564
"United States","Alabama","AL",2020-10-25,2020-10-31,7,2020,"44",4903185,1169,98,988,181,1071,1.99870084445111,3.69147809026174,0.183198380566802
"United States","Alabama","AL",2020-11-01,2020-11-07,7,2020,"45",4903185,1277,115,994,283,1162,2.34541425624365,5.77175856101697,0.284708249496982
"United States","Alabama","AL",2020-11-08,2020-11-14,7,2020,"46",4903185,1269,165,1002,267,1104,3.36515958504523,5.44544005580046,0.266467065868264
"United States","Alabama","AL",2020-11-15,2020-11-21,7,2020,"47",4903185,1275,211,1028,247,1064,4.30332528754269,5.03754192427983,0.240272373540856
"United States","Alabama","AL",2020-11-22,2020-11-28,7,2020,"48",4903185,1326,115,1045,281,1211,2.34541425624365,5.73096874786491,0.268899521531101
"United States","Alabama","AL",2020-11-29,2020-12-05,7,2020,"49",4903185,1355,304,1059,296,1051,6.20005159911364,6.03689234650538,0.279508970727101
"United States","Alabama","AL",2020-12-06,2020-12-12,7,2020,"50",4903185,1598,205,1082,516,1393,4.1809558480865,10.5237717932324,0.476894639556377
"United States","Alabama","AL",2020-12-13,2020-12-19,7,2020,"51",4903185,1584,310,1094,490,1274,6.32242103856983,9.99350422225553,0.447897623400366
"United States","Alabama","AL",2020-12-20,2020-12-26,7,2020,"52",4903185,1626,294,1108,518,1332,5.99610253335332,10.5645616063844,0.467509025270758
"United States","Alabama","AL",2020-12-27,2021-01-02,7,2020,"53",4903185,1801,188,1124,677,1613,3.83424243629396,13.8073517519735,0.602313167259787
"United States","Alabama","AL",2021-01-03,2021-01-09,7,2021,"1",4903185,1806,428,1128,678,1378,8.72902001454157,13.8277466585495,0.601063829787234
"United States","Alabama","AL",2021-01-10,2021-01-16,7,2021,"2",4903185,1820,819,1126,694,1001,16.70342848577,14.154065163766,0.616341030195382
"United States","Alabama","AL",2021-01-17,2021-01-23,7,2021,"3",4903185,1779,539,1126,653,1240,10.9928546444811,13.3178739941487,0.579928952042629
"United States","Alabama","AL",2021-01-24,2021-01-30,7,2021,"4",4903185,1642,909,1122,520,733,18.5389700776128,10.6053514195365,0.463458110516934
"United States","Alabama","AL",2021-01-31,2021-02-06,7,2021,"5",4903185,1511,956,1115,396,555,19.4975306866863,8.07638300410855,0.355156950672646
"United States","Alabama","AL",2021-02-07,2021-02-13,7,2021,"6",4903185,1427,722,1113,314,705,14.7251225478949,6.40400066487395,0.282120395327943
"United States","Alabama","AL",2021-02-14,2021-02-20,7,2021,"7",4903185,1335,347,1102,233,988,7.077032581883,4.75201323221539,0.211433756805808
"United States","Alabama","AL",2021-02-21,2021-02-27,7,2021,"8",4903185,1316,343,1087,229,973,6.99545295557887,4.67043360591126,0.210671573137075
"United States","Alabama","AL",2021-02-28,2021-03-06,7,2021,"9",4903185,1161,218,1083,78,943,4.44608963357491,1.59080271293047,0.0720221606648199
"United States","Alabama","AL",2021-03-07,2021-03-13,7,2021,"10",4903185,1187,181,1080,107,1006,3.69147809026174,2.18225500363539,0.0990740740740741
"United States","Alabama","AL",2021-03-14,2021-03-20,7,2021,"11",4903185,1059,108,1062,-3,951,2.20264991021142,-0.0611847197280951,-0.00282485875706218
"United States","Alabama","AL",2021-03-21,2021-03-27,7,2021,"12",4903185,1188,89,1062,126,1099,1.81514668526682,2.56975822857999,0.11864406779661
"United States","Alabama","AL",2021-03-28,2021-04-03,7,2021,"13",4903185,1103,110,1045,58,993,2.24343972336349,1.18290458140984,0.0555023923444975
"United States","Alabama","AL",2021-04-04,2021-04-10,7,2021,"14",4903185,1202,72,1048,154,1130,1.46843327347428,3.14081561270888,0.146946564885496
"United States","Alabama","AL",2021-04-11,2021-04-17,7,2021,"15",4903185,1161,78,1037,124,1083,1.59080271293047,2.52896841542793,0.119575699132112
"United States","Alabama","AL",2021-04-18,2021-04-24,7,2021,"16",4903185,1104,61,1028,76,1043,1.24408930113793,1.55001289977841,0.0739299610894941
"United States","Alabama","AL",2021-04-25,2021-05-01,7,2021,"17",4903185,1195,62,1018,177,1133,1.26448420771397,3.60989846395761,0.173870333988212
"United States","Alabama","AL",2021-05-02,2021-05-08,7,2021,"18",4903185,1148,65,1014,134,1083,1.32566892744206,2.73291748118825,0.132149901380671
"United States","Alabama","AL",2021-05-09,2021-05-15,7,2021,"19",4903185,1097,60,1015,82,1037,1.2236943945619,1.6723823392346,0.0807881773399015
"United States","Alabama","AL",2021-05-16,2021-05-22,7,2021,"20",4903185,1094,74,1016,78,1020,1.50922308662635,1.59080271293047,0.0767716535433072
"United States","Alabama","AL",2021-05-23,2021-05-29,7,2021,"21",4903185,1074,34,1006,68,1040,0.693426823585078,1.38685364717016,0.0675944333996024
"United States","Alabama","AL",2021-05-30,2021-06-05,7,2021,"22",4903185,1075,52,996,79,1023,1.06053514195365,1.6111976195065,0.0793172690763053
"United States","Alabama","AL",2021-06-06,2021-06-12,7,2021,"23",4903185,1108,68,992,116,1040,1.38685364717016,2.36580916281968,0.116935483870968
"United States","Alabama","AL",2021-06-13,2021-06-19,7,2021,"24",4903185,1112,40,994,118,1072,0.815796263041268,2.40659897597174,0.118712273641851
"United States","Alabama","AL",2021-06-20,2021-06-26,7,2021,"25",4903185,1033,30,993,40,1003,0.611847197280951,0.815796263041268,0.0402819738167171
"United States","Alabama","AL",2021-06-27,2021-07-03,7,2021,"26",4903185,956,22,985,-29,934,0.448687944672697,-0.591452290704919,-0.0294416243654823
"United States","Alabama","AL",2021-07-04,2021-07-10,7,2021,"27",4903185,835,44,982,-147,791,0.897375889345395,-2.99805126667666,-0.14969450101833
"United States","Alaska","AK",2019-12-29,2020-01-04,7,2020,"1",731545,89,0,86,3,89,0,0.410090971847255,0.0348837209302326
"United States","Alaska","AK",2020-01-05,2020-01-11,7,2020,"2",731545,105,0,85,20,105,0,2.73393981231503,0.235294117647059
"United States","Alaska","AK",2020-01-12,2020-01-18,7,2020,"3",731545,99,0,87,12,99,0,1.64036388738902,0.137931034482759
"United States","Alaska","AK",2020-01-19,2020-01-25,7,2020,"4",731545,97,0,81,16,97,0,2.18715184985203,0.197530864197531
"United States","Alaska","AK",2020-01-26,2020-02-01,7,2020,"5",731545,85,0,79,6,85,0,0.82018194369451,0.0759493670886076
"United States","Alaska","AK",2020-02-02,2020-02-08,7,2020,"6",731545,92,0,78,14,92,0,1.91375786862052,0.17948717948718
"United States","Alaska","AK",2020-02-09,2020-02-15,7,2020,"7",731545,89,0,76,13,89,0,1.77706087800477,0.171052631578947
"United States","Alaska","AK",2020-02-16,2020-02-22,7,2020,"8",731545,83,0,76,7,83,0,0.956878934310261,0.0921052631578947
"United States","Alaska","AK",2020-02-23,2020-02-29,7,2020,"9",731545,84,0,80,4,84,0,0.546787962463006,0.05
"United States","Alaska","AK",2020-03-01,2020-03-07,7,2020,"10",731545,79,0,79,0,79,0,0,0
"United States","Alaska","AK",2020-03-08,2020-03-14,7,2020,"11",731545,92,0,79,13,92,0,1.77706087800477,0.164556962025316
"United States","Alaska","AK",2020-03-15,2020-03-21,7,2020,"12",731545,69,0,81,-12,69,0,-1.64036388738902,-0.148148148148148
"United States","Alaska","AK",2020-03-22,2020-03-28,7,2020,"13",731545,86,2,82,4,84,0.273393981231503,0.546787962463006,0.0487804878048781
"United States","Alaska","AK",2020-03-29,2020-04-04,7,2020,"14",731545,98,3,86,12,95,0.410090971847255,1.64036388738902,0.13953488372093
"United States","Alaska","AK",2020-04-05,2020-04-11,7,2020,"15",731545,84,3,83,1,81,0.410090971847255,0.136696990615752,0.0120481927710843
"United States","Alaska","AK",2020-04-12,2020-04-18,7,2020,"16",731545,80,1,84,-4,79,0.136696990615752,-0.546787962463006,-0.0476190476190477
"United States","Alaska","AK",2020-04-19,2020-04-25,7,2020,"17",731545,61,0,80,-19,61,0,-2.59724282169928,-0.2375
"United States","Alaska","AK",2020-04-26,2020-05-02,7,2020,"18",731545,87,0,79,8,87,0,1.09357592492601,0.10126582278481
"United States","Alaska","AK",2020-05-03,2020-05-09,7,2020,"19",731545,89,1,77,12,88,0.136696990615752,1.64036388738902,0.155844155844156
"United States","Alaska","AK",2020-05-10,2020-05-16,7,2020,"20",731545,84,0,77,7,84,0,0.956878934310261,0.0909090909090908
"United States","Alaska","AK",2020-05-17,2020-05-23,7,2020,"21",731545,82,0,77,5,82,0,0.683484953078758,0.0649350649350648
"United States","Alaska","AK",2020-05-24,2020-05-30,7,2020,"22",731545,97,0,79,18,97,0,2.46054583108353,0.227848101265823
"United States","Alaska","AK",2020-05-31,2020-06-06,7,2020,"23",731545,79,0,81,-2,79,0,-0.273393981231503,-0.0246913580246914
"United States","Alaska","AK",2020-06-07,2020-06-13,7,2020,"24",731545,88,2,80,8,86,0.273393981231503,1.09357592492601,0.1
"United States","Alaska","AK",2020-06-14,2020-06-20,7,2020,"25",731545,92,0,84,8,92,0,1.09357592492601,0.0952380952380953
"United States","Alaska","AK",2020-06-21,2020-06-27,7,2020,"26",731545,90,0,87,3,90,0,0.410090971847255,0.0344827586206897
"United States","Alaska","AK",2020-06-28,2020-07-04,7,2020,"27",731545,84,2,85,-1,82,0.273393981231503,-0.136696990615752,-0.0117647058823529
"United States","Alaska","AK",2020-07-05,2020-07-11,7,2020,"28",731545,101,0,86,15,101,0,2.05045485923627,0.174418604651163
"United States","Alaska","AK",2020-07-12,2020-07-18,7,2020,"29",731545,89,4,89,0,85,0.546787962463006,0,0
"United States","Alaska","AK",2020-07-19,2020-07-25,7,2020,"30",731545,93,2,86,7,91,0.273393981231503,0.956878934310261,0.0813953488372092
"United States","Alaska","AK",2020-07-26,2020-08-01,7,2020,"31",731545,114,4,84,30,110,0.546787962463006,4.10090971847255,0.357142857142857
"United States","Alaska","AK",2020-08-02,2020-08-08,7,2020,"32",731545,101,2,85,16,99,0.273393981231503,2.18715184985203,0.188235294117647
"United States","Alaska","AK",2020-08-09,2020-08-15,7,2020,"33",731545,74,2,86,-12,72,0.273393981231503,-1.64036388738902,-0.13953488372093
"United States","Alaska","AK",2020-08-16,2020-08-22,7,2020,"34",731545,116,3,85,31,113,0.410090971847255,4.2376067090883,0.364705882352941
"United States","Alaska","AK",2020-08-23,2020-08-29,7,2020,"35",731545,93,6,87,6,87,0.82018194369451,0.82018194369451,0.0689655172413792
"United States","Alaska","AK",2020-08-30,2020-09-05,7,2020,"36",731545,105,5,89,16,100,0.683484953078758,2.18715184985203,0.179775280898876
"United States","Alaska","AK",2020-09-06,2020-09-12,7,2020,"37",731545,87,2,87,0,85,0.273393981231503,0,0
"United States","Alaska","AK",2020-09-13,2020-09-19,7,2020,"38",731545,104,1,87,17,103,0.136696990615752,2.32384884046778,0.195402298850575
"United States","Alaska","AK",2020-09-20,2020-09-26,7,2020,"39",731545,114,7,89,25,107,0.956878934310261,3.41742476539379,0.280898876404494
"United States","Alaska","AK",2020-09-27,2020-10-03,7,2020,"40",731545,78,6,91,-13,72,0.82018194369451,-1.77706087800477,-0.142857142857143
"United States","Alaska","AK",2020-10-04,2020-10-10,7,2020,"41",731545,117,2,93,24,115,0.273393981231503,3.28072777477804,0.258064516129032
"United States","Alaska","AK",2020-10-11,2020-10-17,7,2020,"42",731545,101,7,93,8,94,0.956878934310261,1.09357592492601,0.086021505376344
"United States","Alaska","AK",2020-10-18,2020-10-24,7,2020,"43",731545,102,1,90,12,101,0.136696990615752,1.64036388738902,0.133333333333333
"United States","Alaska","AK",2020-10-25,2020-10-31,7,2020,"44",731545,107,14,90,17,93,1.91375786862052,2.32384884046778,0.188888888888889
"United States","Alaska","AK",2020-11-01,2020-11-07,7,2020,"45",731545,114,1,90,24,113,0.136696990615752,3.28072777477804,0.266666666666667
"United States","Alaska","AK",2020-11-08,2020-11-14,7,2020,"46",731545,114,13,88,26,101,1.77706087800477,3.55412175600954,0.295454545454545
"United States","Alaska","AK",2020-11-15,2020-11-21,7,2020,"47",731545,122,0,89,33,122,0,4.5110006903198,0.370786516853933
"United States","Alaska","AK",2020-11-22,2020-11-28,7,2020,"48",731545,114,0,95,19,114,0,2.59724282169928,0.2
"United States","Alaska","AK",2020-11-29,2020-12-05,7,2020,"49",731545,118,0,98,20,118,0,2.73393981231503,0.204081632653061
"United States","Alaska","AK",2020-12-06,2020-12-12,7,2020,"50",731545,135,72,98,37,63,9.84218332433411,5.05778865278281,0.377551020408163
"United States","Alaska","AK",2020-12-13,2020-12-19,7,2020,"51",731545,99,7,99,0,92,0.956878934310261,0,0
"United States","Alaska","AK",2020-12-20,2020-12-26,7,2020,"52",731545,115,16,100,15,99,2.18715184985203,2.05045485923627,0.15
"United States","Alaska","AK",2020-12-27,2021-01-02,7,2020,"53",731545,105,15,101,4,90,2.05045485923627,0.546787962463006,0.0396039603960396
"United States","Alaska","AK",2021-01-03,2021-01-09,7,2021,"1",731545,111,8,101,10,103,1.09357592492601,1.36696990615752,0.0990099009900991
"United States","Alaska","AK",2021-01-10,2021-01-16,7,2021,"2",731545,128,5,103,25,123,0.683484953078758,3.41742476539379,0.242718446601942
"United States","Alaska","AK",2021-01-17,2021-01-23,7,2021,"3",731545,95,29,103,-8,66,3.9642127278568,-1.09357592492601,-0.0776699029126213
"United States","Alaska","AK",2021-01-24,2021-01-30,7,2021,"4",731545,91,3,102,-11,88,0.410090971847255,-1.50366689677327,-0.107843137254902
"United States","Alaska","AK",2021-01-31,2021-02-06,7,2021,"5",731545,88,16,99,-11,72,2.18715184985203,-1.50366689677327,-0.111111111111111
"United States","Alaska","AK",2021-02-07,2021-02-13,7,2021,"6",731545,93,2,97,-4,91,0.273393981231503,-0.546787962463006,-0.0412371134020618
"United States","Alaska","AK",2021-02-14,2021-02-20,7,2021,"7",731545,87,8,95,-8,79,1.09357592492601,-1.09357592492601,-0.0842105263157895
"United States","Alaska","AK",2021-02-21,2021-02-27,7,2021,"8",731545,91,1,94,-3,90,0.136696990615752,-0.410090971847255,-0.0319148936170213
"United States","Alaska","AK",2021-02-28,2021-03-06,7,2021,"9",731545,98,12,93,5,86,1.64036388738902,0.683484953078758,0.053763440860215
"United States","Alaska","AK",2021-03-07,2021-03-13,7,2021,"10",731545,82,1,96,-14,81,0.136696990615752,-1.91375786862052,-0.145833333333333
"United States","Alaska","AK",2021-03-14,2021-03-20,7,2021,"11",731545,99,4,94,5,95,0.546787962463006,0.683484953078758,0.053191489361702
"United States","Alaska","AK",2021-03-21,2021-03-27,7,2021,"12",731545,87,3,93,-6,84,0.410090971847255,-0.82018194369451,-0.0645161290322581
"United States","Alaska","AK",2021-03-28,2021-04-03,7,2021,"13",731545,78,0,90,-12,78,0,-1.64036388738902,-0.133333333333333
"United States","Alaska","AK",2021-04-04,2021-04-10,7,2021,"14",731545,88,11,92,-4,77,1.50366689677327,-0.546787962463006,-0.0434782608695652
"United States","Alaska","AK",2021-04-11,2021-04-17,7,2021,"15",731545,77,20,93,-16,57,2.73393981231503,-2.18715184985203,-0.172043010752688
"United States","Alaska","AK",2021-04-18,2021-04-24,7,2021,"16",731545,62,0,93,-31,62,0,-4.2376067090883,-0.333333333333333
"United States","Alaska","AK",2021-04-25,2021-05-01,7,2021,"17",731545,72,12,92,-20,60,1.64036388738902,-2.73393981231503,-0.217391304347826
"United States","Arizona","AZ",2019-12-29,2020-01-04,7,2020,"1",7278717,1299,0,1303,-4,1299,0,-0.0549547399631006,-0.00306983883346124
"United States","Arizona","AZ",2020-01-05,2020-01-11,7,2020,"2",7278717,1391,0,1328,63,1391,0,0.865537154418835,0.0474397590361446
"United States","Arizona","AZ",2020-01-12,2020-01-18,7,2020,"3",7278717,1315,0,1329,-14,1315,0,-0.192341589870852,-0.0105342362678705
"United States","Arizona","AZ",2020-01-19,2020-01-25,7,2020,"4",7278717,1275,0,1327,-52,1275,0,-0.714411619520308,-0.0391861341371514
"United States","Arizona","AZ",2020-01-26,2020-02-01,7,2020,"5",7278717,1265,0,1328,-63,1265,0,-0.865537154418835,-0.0474397590361446
"United States","Arizona","AZ",2020-02-02,2020-02-08,7,2020,"6",7278717,1264,0,1318,-54,1264,0,-0.741888989501859,-0.0409711684370258
"United States","Arizona","AZ",2020-02-09,2020-02-15,7,2020,"7",7278717,1314,0,1314,0,1314,0,0,0
"United States","Arizona","AZ",2020-02-16,2020-02-22,7,2020,"8",7278717,1342,0,1302,40,1342,0,0.549547399631006,0.0307219662058371
"United States","Arizona","AZ",2020-02-23,2020-02-29,7,2020,"9",7278717,1353,0,1307,46,1353,0,0.631979509575657,0.0351951032899771
"United States","Arizona","AZ",2020-03-01,2020-03-07,7,2020,"10",7278717,1380,0,1316,64,1380,0,0.87927583940961,0.0486322188449848
"United States","Arizona","AZ",2020-03-08,2020-03-14,7,2020,"11",7278717,1349,0,1322,27,1349,0,0.370944494750929,0.0204236006051437
"United States","Arizona","AZ",2020-03-15,2020-03-21,7,2020,"12",7278717,1290,1,1316,-26,1289,0.0137386849907752,-0.357205809760154,-0.0197568389057751
"United States","Arizona","AZ",2020-03-22,2020-03-28,7,2020,"13",7278717,1324,14,1304,20,1310,0.192341589870852,0.274773699815503,0.0153374233128833
"United States","Arizona","AZ",2020-03-29,2020-04-04,7,2020,"14",7278717,1357,37,1289,68,1320,0.508331344658681,0.934230579372711,0.0527540729247478
"United States","Arizona","AZ",2020-04-05,2020-04-11,7,2020,"15",7278717,1403,56,1278,125,1347,0.769366359483409,1.7173356238469,0.0978090766823161
"United States","Arizona","AZ",2020-04-12,2020-04-18,7,2020,"16",7278717,1316,68,1272,44,1248,0.934230579372711,0.604502139594107,0.0345911949685536
"United States","Arizona","AZ",2020-04-19,2020-04-25,7,2020,"17",7278717,1384,96,1255,129,1288,1.31891375911442,1.77229036381,0.102788844621514
"United States","Arizona","AZ",2020-04-26,2020-05-02,7,2020,"18",7278717,1404,74,1224,180,1330,1.01666268931736,2.47296329833953,0.147058823529412
"United States","Arizona","AZ",2020-05-03,2020-05-09,7,2020,"19",7278717,1427,183,1212,215,1244,2.51417935331185,2.95381727301666,0.177392739273927
"United States","Arizona","AZ",2020-05-10,2020-05-16,7,2020,"20",7278717,1306,147,1198,108,1159,2.01958669364395,1.48377797900372,0.0901502504173624
"United States","Arizona","AZ",2020-05-17,2020-05-23,7,2020,"21",7278717,1289,119,1189,100,1170,1.63490351390224,1.37386849907752,0.0841042893187554
"United States","Arizona","AZ",2020-05-24,2020-05-30,7,2020,"22",7278717,1310,101,1180,130,1209,1.38760718406829,1.78602904880077,0.110169491525424
"United States","Arizona","AZ",2020-05-31,2020-06-06,7,2020,"23",7278717,1399,139,1170,229,1260,1.90967721371775,3.14615886288751,0.195726495726496
"United States","Arizona","AZ",2020-06-07,2020-06-13,7,2020,"24",7278717,1463,148,1177,286,1315,2.03332537863472,3.9292639073617,0.242990654205608
"United States","Arizona","AZ",2020-06-14,2020-06-20,7,2020,"25",7278717,1550,154,1193,357,1396,2.11575748857937,4.90471054170673,0.299245599329422
"United States","Arizona","AZ",2020-06-21,2020-06-27,7,2020,"26",7278717,1617,242,1188,429,1375,3.32476176776759,5.89389586104254,0.361111111111111
"United States","Arizona","AZ",2020-06-28,2020-07-04,7,2020,"27",7278717,1774,226,1171,603,1548,3.10494280791519,8.28442704943742,0.514944491887276
"United States","Arizona","AZ",2020-07-05,2020-07-11,7,2020,"28",7278717,1954,346,1167,787,1608,4.7535850068082,10.8123450877401,0.674378748928878
"United States","Arizona","AZ",2020-07-12,2020-07-18,7,2020,"29",7278717,1995,579,1166,829,1416,7.95469860965882,11.3893698573526,0.710977701543739
"United States","Arizona","AZ",2020-07-19,2020-07-25,7,2020,"30",7278717,1863,556,1149,714,1307,7.63870885487099,9.80942108341346,0.621409921671018
"United States","Arizona","AZ",2020-07-26,2020-08-01,7,2020,"31",7278717,1792,461,1147,645,1331,6.33353378074735,8.86145181904998,0.562336530078466
"United States","Arizona","AZ",2020-08-02,2020-08-08,7,2020,"32",7278717,1586,390,1139,447,1196,5.35808714640231,6.1411921908765,0.392449517120281
"United States","Arizona","AZ",2020-08-09,2020-08-15,7,2020,"33",7278717,1526,355,1128,398,1171,4.87723317172518,5.46799662632851,0.352836879432624
"United States","Arizona","AZ",2020-08-16,2020-08-22,7,2020,"34",7278717,1505,264,1124,381,1241,3.62701283756464,5.23443898148534,0.338967971530249
"United States","Arizona","AZ",2020-08-23,2020-08-29,7,2020,"35",7278717,1467,251,1125,342,1216,3.44840993268456,4.6986302668451,0.304
"United States","Arizona","AZ",2020-08-30,2020-09-05,7,2020,"36",7278717,1296,200,1120,176,1096,2.74773699815503,2.41800855837643,0.157142857142857
"United States","Arizona","AZ",2020-09-06,2020-09-12,7,2020,"37",7278717,1282,108,1123,159,1174,1.48377797900372,2.18445091353325,0.141585040071238
"United States","Arizona","AZ",2020-09-13,2020-09-19,7,2020,"38",7278717,1259,152,1118,141,1107,2.08828011859782,1.9371545836993,0.126118067978533
"United States","Arizona","AZ",2020-09-20,2020-09-26,7,2020,"39",7278717,1285,155,1114,171,1130,2.12949617357015,2.34931513342255,0.153500897666068
"United States","Arizona","AZ",2020-09-27,2020-10-03,7,2020,"40",7278717,1202,83,1117,85,1119,1.14031085423434,1.16778822421589,0.0760966875559534
"United States","Arizona","AZ",2020-10-04,2020-10-10,7,2020,"41",7278717,1241,54,1125,116,1187,0.741888989501859,1.59368745892992,0.103111111111111
"United States","Arizona","AZ",2020-10-11,2020-10-17,7,2020,"42",7278717,1236,65,1117,119,1171,0.893014524400385,1.63490351390224,0.106535362578335
"United States","Arizona","AZ",2020-10-18,2020-10-24,7,2020,"43",7278717,1282,45,1136,146,1237,0.618240824584882,2.00584800865317,0.128521126760563
"United States","Arizona","AZ",2020-10-25,2020-10-31,7,2020,"44",7278717,1312,109,1145,167,1203,1.49751666399449,2.29436039345945,0.145851528384279
"United States","Arizona","AZ",2020-11-01,2020-11-07,7,2020,"45",7278717,1399,169,1160,239,1230,2.321837763441,3.28354571279526,0.206034482758621
"United States","Arizona","AZ",2020-11-08,2020-11-14,7,2020,"46",7278717,1252,152,1172,80,1100,2.08828011859782,1.09909479926201,0.0682593856655289
"United States","Arizona","AZ",2020-11-15,2020-11-21,7,2020,"47",7278717,1525,157,1197,328,1368,2.1569735435517,4.50628867697425,0.274018379281537
"United States","Arizona","AZ",2020-11-22,2020-11-28,7,2020,"48",7278717,1531,168,1203,328,1363,2.30809907845023,4.50628867697425,0.27265170407315
"United States","Arizona","AZ",2020-11-29,2020-12-05,7,2020,"49",7278717,1696,301,1230,466,1395,4.13534418222332,6.40222720570122,0.378861788617886
"United States","Arizona","AZ",2020-12-06,2020-12-12,7,2020,"50",7278717,2004,397,1235,769,1607,5.45425794133774,10.5650487579061,0.622672064777328
"United States","Arizona","AZ",2020-12-13,2020-12-19,7,2020,"51",7278717,2098,615,1272,826,1483,8.44929126932672,11.3481538023803,0.64937106918239
"United States","Arizona","AZ",2020-12-20,2020-12-26,7,2020,"52",7278717,2205,34,1295,910,2171,0.467115289686355,12.5022033416054,0.702702702702703
"United States","Arizona","AZ",2020-12-27,2021-01-02,7,2020,"53",7278717,2301,1090,1337,964,1211,14.9751666399449,13.2440923311073,0.721017202692595
"United States","Arizona","AZ",2021-01-03,2021-01-09,7,2021,"1",7278717,2423,975,1352,1071,1448,13.3952178660058,14.7141316251202,0.792159763313609
"United States","Arizona","AZ",2021-01-10,2021-01-16,7,2021,"2",7278717,2465,1212,1360,1105,1253,16.6512862088195,15.1812469148066,0.8125
"United States","Arizona","AZ",2021-01-17,2021-01-23,7,2021,"3",7278717,2404,922,1342,1062,1482,12.6670675614947,14.5904834602032,0.791356184798808
"United States","Arizona","AZ",2021-01-24,2021-01-30,7,2021,"4",7278717,2081,927,1324,757,1154,12.7357609864486,10.4001845380168,0.571752265861027
"United States","Arizona","AZ",2021-01-31,2021-02-06,7,2021,"5",7278717,1994,910,1318,676,1084,12.5022033416054,9.28735105376401,0.512898330804249
"United States","Arizona","AZ",2021-02-07,2021-02-13,7,2021,"6",7278717,1738,939,1286,452,799,12.9006252063379,6.20988561583037,0.351477449455676
"United States","Arizona","AZ",2021-02-14,2021-02-20,7,2021,"7",7278717,1560,533,1280,280,1027,7.32271910008316,3.84683179741705,0.21875
"United States","Arizona","AZ",2021-02-21,2021-02-27,7,2021,"8",7278717,1523,501,1285,238,1022,6.88308118037836,3.26980702780449,0.185214007782101
"United States","Arizona","AZ",2021-02-28,2021-03-06,7,2021,"9",7278717,1502,289,1274,228,1213,3.97047996233402,3.13242017789674,0.178963893249608
"United States","Arizona","AZ",2021-03-07,2021-03-13,7,2021,"10",7278717,1418,284,1265,153,1134,3.90178653738015,2.1020188035886,0.12094861660079
"United States","Arizona","AZ",2021-03-14,2021-03-20,7,2021,"11",7278717,1396,139,1254,142,1257,1.90967721371775,1.95089326869007,0.113237639553429
"United States","Arizona","AZ",2021-03-21,2021-03-27,7,2021,"12",7278717,1295,226,1269,26,1069,3.10494280791519,0.357205809760154,0.0204885736800631
"United States","Arizona","AZ",2021-03-28,2021-04-03,7,2021,"13",7278717,1353,87,1258,95,1266,1.19526559419744,1.30517507412364,0.0755166931637521
"United States","Arizona","AZ",2021-04-04,2021-04-10,7,2021,"14",7278717,1279,81,1244,35,1198,1.11283348425279,0.480853974677131,0.0281350482315113
"United States","Arizona","AZ",2021-04-11,2021-04-17,7,2021,"15",7278717,1325,65,1230,95,1260,0.893014524400385,1.30517507412364,0.0772357723577235
"United States","Arizona","AZ",2021-04-18,2021-04-24,7,2021,"16",7278717,1256,117,1226,30,1139,1.60742614392069,0.412160549723255,0.0244698205546492
"United States","Arizona","AZ",2021-04-25,2021-05-01,7,2021,"17",7278717,1283,70,1203,80,1213,0.961707949354261,1.09909479926201,0.0665004156275977
"United States","Arizona","AZ",2021-05-02,2021-05-08,7,2021,"18",7278717,1421,69,1189,232,1352,0.947969264363486,3.18737491785984,0.195121951219512
"United States","Arizona","AZ",2021-05-09,2021-05-15,7,2021,"19",7278717,1327,59,1176,151,1268,0.810582414455735,2.07454143360705,0.128401360544218
"United States","Arizona","AZ",2021-05-16,2021-05-22,7,2021,"20",7278717,1267,81,1156,111,1186,1.11283348425279,1.52499403397604,0.0960207612456747
"United States","Arizona","AZ",2021-05-23,2021-05-29,7,2021,"21",7278717,1269,81,1148,121,1188,1.11283348425279,1.66238088388379,0.105400696864111
"United States","Arizona","AZ",2021-05-30,2021-06-05,7,2021,"22",7278717,1350,72,1144,206,1278,0.989185319335812,2.83016910809968,0.18006993006993
"United States","Arizona","AZ",2021-06-06,2021-06-12,7,2021,"23",7278717,1305,40,1164,141,1265,0.549547399631006,1.9371545836993,0.121134020618557
"United States","Arizona","AZ",2021-06-13,2021-06-19,7,2021,"24",7278717,1371,82,1166,205,1289,1.12657216924356,2.81643042310891,0.175814751286449
"United States","Arizona","AZ",2021-06-20,2021-06-26,7,2021,"25",7278717,1385,81,1169,216,1304,1.11283348425279,2.96755595800743,0.184773310521813
"United States","Arizona","AZ",2021-06-27,2021-07-03,7,2021,"26",7278717,1293,58,1164,129,1235,0.796843729464959,1.77229036381,0.110824742268041
"United States","Arizona","AZ",2021-07-04,2021-07-10,7,2021,"27",7278717,1094,48,1174,-80,1046,0.659456879557208,-1.09909479926201,-0.0681431005110733
"United States","Arkansas","AR",2019-12-29,2020-01-04,7,2020,"1",3017825,672,0,735,-63,672,0,-2.08759619924946,-0.0857142857142857
"United States","Arkansas","AR",2020-01-05,2020-01-11,7,2020,"2",3017825,686,0,727,-41,686,0,-1.35859435189251,-0.0563961485557084
"United States","Arkansas","AR",2020-01-12,2020-01-18,7,2020,"3",3017825,658,0,687,-29,658,0,-0.960956980606894,-0.0422125181950509
"United States","Arkansas","AR",2020-01-19,2020-01-25,7,2020,"4",3017825,616,0,674,-58,616,0,-1.92191396121379,-0.086053412462908
"United States","Arkansas","AR",2020-01-26,2020-02-01,7,2020,"5",3017825,681,0,674,7,681,0,0.23195513324994,0.0103857566765579
"United States","Arkansas","AR",2020-02-02,2020-02-08,7,2020,"6",3017825,673,0,664,9,673,0,0.298228028464209,0.0135542168674698
"United States","Arkansas","AR",2020-02-09,2020-02-15,7,2020,"7",3017825,688,0,673,15,688,0,0.497046714107014,0.0222882615156017
"United States","Arkansas","AR",2020-02-16,2020-02-22,7,2020,"8",3017825,697,0,667,30,697,0,0.994093428214028,0.0449775112443778
"United States","Arkansas","AR",2020-02-23,2020-02-29,7,2020,"9",3017825,656,0,652,4,656,0,0.132545790428537,0.00613496932515334
"United States","Arkansas","AR",2020-03-01,2020-03-07,7,2020,"10",3017825,697,0,648,49,697,0,1.62368593274958,0.0756172839506173
"United States","Arkansas","AR",2020-03-08,2020-03-14,7,2020,"11",3017825,628,0,638,-10,628,0,-0.331364476071343,-0.0156739811912225
"United States","Arkansas","AR",2020-03-15,2020-03-21,7,2020,"12",3017825,640,0,639,1,640,0,0.0331364476071343,0.00156494522691708
"United States","Arkansas","AR",2020-03-22,2020-03-28,7,2020,"13",3017825,641,5,629,12,636,0.165682238035671,0.397637371285611,0.0190779014308426
"United States","Arkansas","AR",2020-03-29,2020-04-04,7,2020,"14",3017825,606,8,623,-17,598,0.265091580857074,-0.563319609321283,-0.0272873194221509
"United States","Arkansas","AR",2020-04-05,2020-04-11,7,2020,"15",3017825,636,12,623,13,624,0.397637371285611,0.430773818892746,0.0208667736757624
"United States","Arkansas","AR",2020-04-12,2020-04-18,7,2020,"16",3017825,637,12,623,14,625,0.397637371285611,0.46391026649988,0.0224719101123596
"United States","Arkansas","AR",2020-04-19,2020-04-25,7,2020,"17",3017825,615,10,620,-5,605,0.331364476071343,-0.165682238035671,-0.00806451612903225
"United States","Arkansas","AR",2020-04-26,2020-05-02,7,2020,"18",3017825,630,25,610,20,605,0.828411190178357,0.662728952142685,0.0327868852459017
"United States","Arkansas","AR",2020-05-03,2020-05-09,7,2020,"19",3017825,661,16,607,54,645,0.530183161714148,1.78936817078525,0.0889621087314663
"United States","Arkansas","AR",2020-05-10,2020-05-16,7,2020,"20",3017825,583,10,605,-22,573,0.331364476071343,-0.729001847356954,-0.0363636363636364
"United States","Arkansas","AR",2020-05-17,2020-05-23,7,2020,"21",3017825,642,17,603,39,625,0.563319609321283,1.29232145667824,0.0646766169154229
"United States","Arkansas","AR",2020-05-24,2020-05-30,7,2020,"22",3017825,610,18,602,8,592,0.596456056928417,0.265091580857074,0.0132890365448506
"United States","Arkansas","AR",2020-05-31,2020-06-06,7,2020,"23",3017825,649,20,596,53,629,0.662728952142685,1.75623172317812,0.0889261744966443
"United States","Arkansas","AR",2020-06-07,2020-06-13,7,2020,"24",3017825,652,24,586,66,628,0.795274742571223,2.18700554207086,0.112627986348123
"United States","Arkansas","AR",2020-06-14,2020-06-20,7,2020,"25",3017825,708,47,589,119,661,1.55741303753531,3.94323726524898,0.202037351443124
"United States","Arkansas","AR",2020-06-21,2020-06-27,7,2020,"26",3017825,663,35,594,69,628,1.1597756662497,2.28641488489227,0.116161616161616
"United States","Arkansas","AR",2020-06-28,2020-07-04,7,2020,"27",3017825,687,27,595,92,660,0.894684085392626,3.04855317985635,0.154621848739496
"United States","Arkansas","AR",2020-07-05,2020-07-11,7,2020,"28",3017825,661,33,591,70,628,1.09350277103543,2.3195513324994,0.11844331641286
"United States","Arkansas","AR",2020-07-12,2020-07-18,7,2020,"29",3017825,695,38,578,117,657,1.2591850090711,3.87696437003471,0.20242214532872
"United States","Arkansas","AR",2020-07-19,2020-07-25,7,2020,"30",3017825,714,42,575,139,672,1.39173079949964,4.60596621739166,0.241739130434783
"United States","Arkansas","AR",2020-07-26,2020-08-01,7,2020,"31",3017825,750,59,570,180,691,1.95505040882092,5.96456056928417,0.315789473684211
"United States","Arkansas","AR",2020-08-02,2020-08-08,7,2020,"32",3017825,736,77,563,173,659,2.55150646574934,5.73260543603423,0.307282415630551
"United States","Arkansas","AR",2020-08-09,2020-08-15,7,2020,"33",3017825,766,65,565,201,701,2.15386909446373,6.66042596903399,0.355752212389381
"United States","Arkansas","AR",2020-08-16,2020-08-22,7,2020,"34",3017825,750,74,560,190,676,2.45209712292794,6.29592504535551,0.339285714285714
"United States","Arkansas","AR",2020-08-23,2020-08-29,7,2020,"35",3017825,739,98,571,168,641,3.24737186549916,5.56692319799856,0.294220665499124
"United States","Arkansas","AR",2020-08-30,2020-09-05,7,2020,"36",3017825,713,110,575,138,603,3.64500923678477,4.57282976978453,0.24
"United States","Arkansas","AR",2020-09-06,2020-09-12,7,2020,"37",3017825,722,71,579,143,651,2.35268778010653,4.7385120078202,0.246977547495682
"United States","Arkansas","AR",2020-09-13,2020-09-19,7,2020,"38",3017825,736,228,582,154,508,7.55511005442661,5.10301293149868,0.264604810996564
"United States","Arkansas","AR",2020-09-20,2020-09-26,7,2020,"39",3017825,746,104,584,162,642,3.44619055114196,5.36810451235575,0.277397260273973
"United States","Arkansas","AR",2020-09-27,2020-10-03,7,2020,"40",3017825,784,122,579,205,662,4.04264660807038,6.79297175946253,0.35405872193437
"United States","Arkansas","AR",2020-10-04,2020-10-10,7,2020,"41",3017825,785,145,573,212,640,4.80478490303447,7.02492689271247,0.369982547993019
"United States","Arkansas","AR",2020-10-11,2020-10-17,7,2020,"42",3017825,778,132,593,185,646,4.37401108414173,6.13024280731984,0.311973018549747
"United States","Arkansas","AR",2020-10-18,2020-10-24,7,2020,"43",3017825,794,113,599,195,681,3.74441857960617,6.46160728339118,0.325542570951586
"United States","Arkansas","AR",2020-10-25,2020-10-31,7,2020,"44",3017825,790,127,612,178,663,4.20832884610605,5.8982876740699,0.290849673202614
"United States","Arkansas","AR",2020-11-01,2020-11-07,7,2020,"45",3017825,845,142,627,218,703,4.70537556021307,7.22374557835527,0.347687400318979
"United States","Arkansas","AR",2020-11-08,2020-11-14,7,2020,"46",3017825,893,89,632,261,804,2.94914383703495,8.64861282546205,0.412974683544304
"United States","Arkansas","AR",2020-11-15,2020-11-21,7,2020,"47",3017825,876,174,630,246,702,5.76574188364136,8.15156611135503,0.39047619047619
"United States","Arkansas","AR",2020-11-22,2020-11-28,7,2020,"48",3017825,833,107,644,189,726,3.54559989396337,6.26278859774838,0.293478260869565
"United States","Arkansas","AR",2020-11-29,2020-12-05,7,2020,"49",3017825,944,184,657,287,760,6.09710635971271,9.51016046324754,0.436834094368341
"United States","Arkansas","AR",2020-12-06,2020-12-12,7,2020,"50",3017825,912,290,667,245,622,9.60956980606894,8.1184296637479,0.367316341829085
"United States","Arkansas","AR",2020-12-13,2020-12-19,7,2020,"51",3017825,936,281,688,248,655,9.31134177760473,8.2178390065693,0.36046511627907
"United States","Arkansas","AR",2020-12-20,2020-12-26,7,2020,"52",3017825,922,250,697,225,672,8.28411190178357,7.45570071160521,0.322812051649928
"United States","Arkansas","AR",2020-12-27,2021-01-02,7,2020,"53",3017825,968,288,700,268,680,9.54329691085467,8.88056795871199,0.382857142857143
"United States","Arkansas","AR",2021-01-03,2021-01-09,7,2021,"1",3017825,962,281,704,258,681,9.31134177760473,8.54920348264064,0.366477272727273
"United States","Arkansas","AR",2021-01-10,2021-01-16,7,2021,"2",3017825,962,283,698,264,679,9.377614672819,8.74802216828345,0.378223495702006
"United States","Arkansas","AR",2021-01-17,2021-01-23,7,2021,"3",3017825,983,270,672,311,713,8.94684085392626,10.3054352058188,0.462797619047619
"United States","Arkansas","AR",2021-01-24,2021-01-30,7,2021,"4",3017825,881,275,672,209,606,9.11252309196193,6.92551754989106,0.311011904761905
"United States","Arkansas","AR",2021-01-31,2021-02-06,7,2021,"5",3017825,870,223,675,195,647,7.38942781639094,6.46160728339118,0.288888888888889
"United States","Arkansas","AR",2021-02-07,2021-02-13,7,2021,"6",3017825,808,191,672,136,617,6.32906149296265,4.50655687457026,0.202380952380952
"United States","Arkansas","AR",2021-02-14,2021-02-20,7,2021,"7",3017825,779,96,663,116,683,3.18109897028489,3.84382792242758,0.174962292609351
"United States","Arkansas","AR",2021-02-21,2021-02-27,7,2021,"8",3017825,795,72,660,135,723,2.38582422771367,4.47342042696313,0.204545454545455
"United States","Arkansas","AR",2021-02-28,2021-03-06,7,2021,"9",3017825,747,19,653,94,728,0.629592504535551,3.11482607507062,0.143950995405819
"United States","Arkansas","AR",2021-03-07,2021-03-13,7,2021,"10",3017825,724,87,640,84,637,2.88287094182068,2.78346159899928,0.13125
"United States","Arkansas","AR",2021-03-14,2021-03-20,7,2021,"11",3017825,648,67,635,13,581,2.220141989678,0.430773818892746,0.020472440944882
"United States","Arkansas","AR",2021-03-21,2021-03-27,7,2021,"12",3017825,704,49,626,78,655,1.62368593274958,2.58464291335647,0.124600638977636
"United States","Arkansas","AR",2021-03-28,2021-04-03,7,2021,"13",3017825,602,-1,611,-9,603,-0.0331364476071343,-0.298228028464209,-0.0147299509001637
"United States","Arkansas","AR",2021-04-04,2021-04-10,7,2021,"14",3017825,694,20,606,88,674,0.662728952142685,2.91600738942782,0.145214521452145
"United States","Arkansas","AR",2021-04-11,2021-04-17,7,2021,"15",3017825,613,32,602,11,581,1.0603663234283,0.364500923678477,0.0182724252491695
"United States","Arkansas","AR",2021-04-18,2021-04-24,7,2021,"16",3017825,664,24,598,66,640,0.795274742571223,2.18700554207086,0.110367892976589
"United States","Arkansas","AR",2021-04-25,2021-05-01,7,2021,"17",3017825,652,24,598,54,628,0.795274742571223,1.78936817078525,0.0903010033444815
"United States","Arkansas","AR",2021-05-02,2021-05-08,7,2021,"18",3017825,700,19,595,105,681,0.629592504535551,3.4793269987491,0.176470588235294
"United States","Arkansas","AR",2021-05-09,2021-05-15,7,2021,"19",3017825,694,33,596,98,661,1.09350277103543,3.24737186549916,0.164429530201342
"United States","Arkansas","AR",2021-05-16,2021-05-22,7,2021,"20",3017825,682,23,597,85,659,0.762138294964088,2.81659804660641,0.142378559463987
"United States","Arkansas","AR",2021-05-23,2021-05-29,7,2021,"21",3017825,655,14,596,59,641,0.46391026649988,1.95505040882092,0.098993288590604
"United States","Arkansas","AR",2021-05-30,2021-06-05,7,2021,"22",3017825,679,16,591,88,663,0.530183161714148,2.91600738942782,0.148900169204738
"United States","Arkansas","AR",2021-06-06,2021-06-12,7,2021,"23",3017825,665,14,589,76,651,0.46391026649988,2.51837001814221,0.129032258064516
"United States","Arkansas","AR",2021-06-13,2021-06-19,7,2021,"24",3017825,695,14,591,104,681,0.46391026649988,3.44619055114196,0.175972927241963
"United States","Arkansas","AR",2021-06-20,2021-06-26,7,2021,"25",3017825,661,19,591,70,642,0.629592504535551,2.3195513324994,0.11844331641286
"United States","Arkansas","AR",2021-06-27,2021-07-03,7,2021,"26",3017825,660,20,585,75,640,0.662728952142685,2.48523357053507,0.128205128205128
"United States","Arkansas","AR",2021-07-04,2021-07-10,7,2021,"27",3017825,570,35,582,-12,535,1.1597756662497,-0.397637371285611,-0.020618556701031
"United States","California","CA",2019-12-29,2020-01-04,7,2020,"1",39512223,5888,0,6275,-387,5888,0,-0.979443753392463,-0.0616733067729084
"United States","California","CA",2020-01-05,2020-01-11,7,2020,"2",39512223,5873,0,6275,-402,5873,0,-1.01740668957047,-0.0640637450199203
"United States","California","CA",2020-01-12,2020-01-18,7,2020,"3",39512223,5830,0,6154,-324,5830,0,-0.819999421444853,-0.0526486837829054
"United States","California","CA",2020-01-19,2020-01-25,7,2020,"4",39512223,5832,0,6045,-213,5832,0,-0.539073693727635,-0.0352357320099256
"United States","California","CA",2020-01-26,2020-02-01,7,2020,"5",39512223,5686,0,5983,-297,5686,0,-0.751666136324448,-0.0496406485040949
"United States","California","CA",2020-02-02,2020-02-08,7,2020,"6",39512223,5913,1,5890,23,5912,0.00253086241186683,0.0582098354729371,0.00390492359932093
"United States","California","CA",2020-02-09,2020-02-15,7,2020,"7",39512223,5588,0,5850,-262,5588,0,-0.663085951909109,-0.0447863247863248
"United States","California","CA",2020-02-16,2020-02-22,7,2020,"8",39512223,5797,1,5770,27,5796,0.00253086241186683,0.0683332851204044,0.00467937608318891
"United States","California","CA",2020-02-23,2020-02-29,7,2020,"9",39512223,5680,0,5729,-49,5680,0,-0.124012258181475,-0.00855297608657701
"United States","California","CA",2020-03-01,2020-03-07,7,2020,"10",39512223,5736,2,5760,-24,5734,0.00506172482373366,-0.0607406978848039,-0.00416666666666665
"United States","California","CA",2020-03-08,2020-03-14,7,2020,"11",39512223,5465,3,5695,-230,5462,0.00759258723560049,-0.582098354729371,-0.0403863037752414
"United States","California","CA",2020-03-15,2020-03-21,7,2020,"12",39512223,5681,23,5612,69,5658,0.0582098354729371,0.174629506418811,0.0122950819672132
"United States","California","CA",2020-03-22,2020-03-28,7,2020,"13",39512223,5689,94,5479,210,5595,0.237901066715482,0.531481106492034,0.0383281620733711
"United States","California","CA",2020-03-29,2020-04-04,7,2020,"14",39512223,5986,199,5373,613,5787,0.503641619961499,1.55141865847437,0.114088963335194
"United States","California","CA",2020-04-05,2020-04-11,7,2020,"15",39512223,6047,309,5311,736,5738,0.78203648526685,1.86271473513399,0.138580305027302
"United States","California","CA",2020-04-12,2020-04-18,7,2020,"16",39512223,6131,515,5281,850,5616,1.30339414211142,2.1512330500868,0.160954364703655
"United States","California","CA",2020-04-19,2020-04-25,7,2020,"17",39512223,5938,543,5233,705,5395,1.37425828964369,1.78425800036611,0.134721956812536
"United States","California","CA",2020-04-26,2020-05-02,7,2020,"18",39512223,5744,495,5142,602,5249,1.25277689387408,1.52357917194383,0.1170750680669
"United States","California","CA",2020-05-03,2020-05-09,7,2020,"19",39512223,5671,504,5083,588,5167,1.27555465558088,1.4881470981777,0.115679716702735
"United States","California","CA",2020-05-10,2020-05-16,7,2020,"20",39512223,5695,519,5059,636,5176,1.31351759175888,1.6096284939473,0.125716544771694
"United States","California","CA",2020-05-17,2020-05-23,7,2020,"21",39512223,5530,527,5037,493,5003,1.33376449105382,1.24771516905035,0.0978757196744093
"United States","California","CA",2020-05-24,2020-05-30,7,2020,"22",39512223,5593,406,4964,629,5187,1.02753013921793,1.59191245706424,0.126712328767123
"United States","California","CA",2020-05-31,2020-06-06,7,2020,"23",39512223,5518,463,4955,563,5055,1.17178929669434,1.42487553788102,0.113622603430878
"United States","California","CA",2020-06-07,2020-06-13,7,2020,"24",39512223,5570,451,4949,621,5119,1.14141894775194,1.5716655577693,0.125479894928268
"United States","California","CA",2020-06-14,2020-06-20,7,2020,"25",39512223,5489,431,4973,516,5058,1.0908016995146,1.30592500452328,0.103760305650513
"United States","California","CA",2020-06-21,2020-06-27,7,2020,"26",39512223,5701,412,4953,748,5289,1.04271531368913,1.89308508407639,0.15101958409045
"United States","California","CA",2020-06-28,2020-07-04,7,2020,"27",39512223,5901,432,4924,977,5469,1.09333256192647,2.47265257639389,0.198415922014622
"United States","California","CA",2020-07-05,2020-07-11,7,2020,"28",39512223,6042,696,4878,1164,5346,1.76148023865931,2.94592384741299,0.238622386223862
"United States","California","CA",2020-07-12,2020-07-18,7,2020,"29",39512223,6230,676,4809,1421,5554,1.71086299042198,3.59635548726276,0.295487627365357
"United States","California","CA",2020-07-19,2020-07-25,7,2020,"30",39512223,6250,726,4783,1467,5524,1.83740611101532,3.71277515820864,0.306711269077985
"United States","California","CA",2020-07-26,2020-08-01,7,2020,"31",39512223,6339,933,4737,1602,5406,2.36129463027175,4.05444158381066,0.338188727042432
"United States","California","CA",2020-08-02,2020-08-08,7,2020,"32",39512223,6309,924,4724,1585,5385,2.33851686856495,4.01141692280892,0.335520745131245
"United States","California","CA",2020-08-09,2020-08-15,7,2020,"33",39512223,6291,937,4686,1605,5354,2.37141807991922,4.06203417104626,0.342509603072983
"United States","California","CA",2020-08-16,2020-08-22,7,2020,"34",39512223,6478,894,4694,1784,5584,2.26259099620894,4.51505854277042,0.38005965061781
"United States","California","CA",2020-08-23,2020-08-29,7,2020,"35",39512223,5878,789,4677,1201,5089,1.99685044296293,3.03956575665206,0.256788539662177
"United States","California","CA",2020-08-30,2020-09-05,7,2020,"36",39512223,5784,802,4680,1104,4982,2.0297516543172,2.79407210270098,0.235897435897436
"United States","California","CA",2020-09-06,2020-09-12,7,2020,"37",39512223,5874,626,4699,1175,5248,1.58431986982864,2.97376333394352,0.250053202809108
"United States","California","CA",2020-09-13,2020-09-19,7,2020,"38",39512223,5755,654,4749,1006,5101,1.65518401736091,2.54604758633803,0.211834070330596
"United States","California","CA",2020-09-20,2020-09-26,7,2020,"39",39512223,5563,547,4760,803,5016,1.38438173929116,2.03228251672906,0.168697478991597
"United States","California","CA",2020-09-27,2020-10-03,7,2020,"40",39512223,5671,608,4783,888,5063,1.53876434641503,2.24740582173774,0.1856575371106
"United States","California","CA",2020-10-04,2020-10-10,7,2020,"41",39512223,5568,447,4821,747,5121,1.13129549810447,1.89055422166452,0.154947106409459
"United States","California","CA",2020-10-11,2020-10-17,7,2020,"42",39512223,5621,375,4856,765,5246,0.949073404450061,1.93610974507812,0.157537067545305
"United States","California","CA",2020-10-18,2020-10-24,7,2020,"43",39512223,5351,381,4867,484,4970,0.964258578921262,1.22493740734355,0.0994452434764743
"United States","California","CA",2020-10-25,2020-10-31,7,2020,"44",39512223,5529,314,4909,620,5215,0.794690797326184,1.56913469535743,0.12629863515991
"United States","California","CA",2020-11-01,2020-11-07,7,2020,"45",39512223,5872,305,4926,946,5567,0.771913035619383,2.39419584162602,0.192042224928948
"United States","California","CA",2020-11-08,2020-11-14,7,2020,"46",39512223,6004,288,4950,1054,5716,0.728888374617647,2.66752898210764,0.212929292929293
"United States","California","CA",2020-11-15,2020-11-21,7,2020,"47",39512223,6350,345,4999,1351,6005,0.873147532094056,3.41919511843209,0.270254050810162
"United States","California","CA",2020-11-22,2020-11-28,7,2020,"48",39512223,6390,536,5081,1309,5854,1.35654225276062,3.31289889713368,0.257626451485928
"United States","California","CA",2020-11-29,2020-12-05,7,2020,"49",39512223,7164,746,5160,2004,6418,1.88802335925265,5.07184827338113,0.388372093023256
"United States","California","CA",2020-12-06,2020-12-12,7,2020,"50",39512223,8149,1092,5273,2876,7057,2.76370175375858,7.278760296529,0.545420064479423
"United States","California","CA",2020-12-13,2020-12-19,7,2020,"51",39512223,9233,1612,5399,3834,7621,4.07975020792933,9.70332648709742,0.710131505834414
"United States","California","CA",2020-12-20,2020-12-26,7,2020,"52",39512223,10563,1400,5545,5018,9163,3.54320737661356,12.6998675827477,0.904959422903517
"United States","California","CA",2020-12-27,2021-01-02,7,2020,"53",39512223,11269,2374,5694,5575,8895,6.00826736577185,14.1095579461576,0.979100807867931
"United States","California","CA",2021-01-03,2021-01-09,7,2021,"1",39512223,11893,2876,5891,6002,9017,7.278760296529,15.1902361960247,1.01884230181633
"United States","California","CA",2021-01-10,2021-01-16,7,2021,"2",39512223,11562,3727,5913,5649,7835,9.43252420902767,14.2968417646357,0.955352612886859
"United States","California","CA",2021-01-17,2021-01-23,7,2021,"3",39512223,10398,3400,5886,4512,6998,8.60493220034722,11.4192512023431,0.766564729867482
"United States","California","CA",2021-01-24,2021-01-30,7,2021,"4",39512223,9613,3856,5844,3769,5757,9.75900546015849,9.53882043032608,0.644934976043806
"United States","California","CA",2021-01-31,2021-02-06,7,2021,"5",39512223,8791,3431,5817,2974,5360,8.68338893511509,7.52678481289195,0.511260099707753
"United States","California","CA",2021-02-07,2021-02-13,7,2021,"6",39512223,7880,2788,5719,2161,5092,7.05604440428472,5.46919367204422,0.377863262808183
"United States","California","CA",2021-02-14,2021-02-20,7,2021,"7",39512223,7023,2390,5724,1299,4633,6.04876116436172,3.28759027301501,0.226939203354298
"United States","California","CA",2021-02-21,2021-02-27,7,2021,"8",39512223,6728,2996,5720,1008,3732,7.58246378595302,2.55110931116176,0.176223776223776
"United States","California","CA",2021-02-28,2021-03-06,7,2021,"9",39512223,6461,1901,5714,747,4560,4.81116944495884,1.89055422166452,0.130731536576829
"United States","California","CA",2021-03-07,2021-03-13,7,2021,"10",39512223,6208,1513,5660,548,4695,3.82919482915451,1.38691260170302,0.0968197879858657
"United States","California","CA",2021-03-14,2021-03-20,7,2021,"11",39512223,5987,883,5529,458,5104,2.23475150967841,1.15913498463501,0.0828359558690541
"United States","California","CA",2021-03-21,2021-03-27,7,2021,"12",39512223,5788,1628,5433,355,4160,4.1202440065192,0.898456156212724,0.0653414319896926
"United States","California","CA",2021-03-28,2021-04-03,7,2021,"13",39512223,5749,683,5353,396,5066,1.72857902730504,1.00222151509926,0.0739772090416588
"United States","California","CA",2021-04-04,2021-04-10,7,2021,"14",39512223,5419,684,5254,165,4735,1.73110988971691,0.417592297958027,0.0314046440807003
"United States","California","CA",2021-04-11,2021-04-17,7,2021,"15",39512223,5342,577,5204,138,4765,1.46030761164716,0.349259012837622,0.0265180630284396
"United States","California","CA",2021-04-18,2021-04-24,7,2021,"16",39512223,5356,445,5094,262,4911,1.12623377328074,0.663085951909109,0.0514330585001963
"United States","California","CA",2021-04-25,2021-05-01,7,2021,"17",39512223,5381,490,5044,337,4891,1.24012258181475,0.852900632799121,0.066812053925456
"United States","California","CA",2021-05-02,2021-05-08,7,2021,"18",39512223,5349,542,5040,309,4807,1.37172742723182,0.78203648526685,0.0613095238095238
"United States","California","CA",2021-05-09,2021-05-15,7,2021,"19",39512223,5261,277,5025,236,4984,0.701048888087112,0.597283529200572,0.0469651741293533
"United States","California","CA",2021-05-16,2021-05-22,7,2021,"20",39512223,5246,278,5020,226,4968,0.703579750498978,0.571974905081903,0.0450199203187251
"United States","California","CA",2021-05-23,2021-05-29,7,2021,"21",39512223,5330,59,4993,337,5271,0.149320882300143,0.852900632799121,0.0674944922892049
"United States","California","CA",2021-05-30,2021-06-05,7,2021,"22",39512223,5171,247,4981,190,4924,0.625123015731107,0.480863858254698,0.0381449508130898
"United States","California","CA",2021-06-06,2021-06-12,7,2021,"23",39512223,5114,258,5024,90,4856,0.652962502261642,0.227777617068015,0.0179140127388535
"United States","California","CA",2021-06-13,2021-06-19,7,2021,"24",39512223,5348,130,5011,337,5218,0.329012113542688,0.852900632799121,0.0672520454999002
"United States","California","CA",2021-06-20,2021-06-26,7,2021,"25",39512223,5069,323,4990,79,4746,0.817468559032986,0.199938130537479,0.0158316633266533
"United States","California","CA",2021-06-27,2021-07-03,7,2021,"26",39512223,4644,250,4907,-263,4394,0.632715602966707,-0.665616814320976,-0.0535969023843489
"United States","California","CA",2021-07-04,2021-07-10,7,2021,"27",39512223,3946,237,4899,-953,3709,0.599814391612439,-2.41191187850909,-0.194529495815473
"United States","Colorado","CO",2019-12-29,2020-01-04,7,2020,"1",5758736,854,0,840,14,854,0,0.243108904454033,0.0166666666666666
"United States","Colorado","CO",2020-01-05,2020-01-11,7,2020,"2",5758736,872,0,845,27,872,0,0.468852887161349,0.0319526627218936
"United States","Colorado","CO",2020-01-12,2020-01-18,7,2020,"3",5758736,848,0,849,-1,848,0,-0.0173649217467166,-0.00117785630153122
"United States","Colorado","CO",2020-01-19,2020-01-25,7,2020,"4",5758736,853,0,837,16,853,0,0.277838747947466,0.0191158900836321
"United States","Colorado","CO",2020-01-26,2020-02-01,7,2020,"5",5758736,793,0,825,-32,793,0,-0.555677495894932,-0.0387878787878788
"United States","Colorado","CO",2020-02-02,2020-02-08,7,2020,"6",5758736,847,0,824,23,847,0,0.399393200174483,0.0279126213592233
"United States","Colorado","CO",2020-02-09,2020-02-15,7,2020,"7",5758736,807,0,818,-11,807,0,-0.191014139213883,-0.0134474327628362
"United States","Colorado","CO",2020-02-16,2020-02-22,7,2020,"8",5758736,881,0,815,66,881,0,1.1460848352833,0.0809815950920245
"United States","Colorado","CO",2020-02-23,2020-02-29,7,2020,"9",5758736,842,0,813,29,842,0,0.503582730654783,0.035670356703567
"United States","Colorado","CO",2020-03-01,2020-03-07,7,2020,"10",5758736,821,0,815,6,821,0,0.1041895304803,0.00736196319018401
"United States","Colorado","CO",2020-03-08,2020-03-14,7,2020,"11",5758736,822,1,811,11,821,0.0173649217467166,0.191014139213883,0.0135635018495683
"United States","Colorado","CO",2020-03-15,2020-03-21,7,2020,"12",5758736,891,5,813,78,886,0.0868246087335832,1.3544638962439,0.0959409594095941
"United States","Colorado","CO",2020-03-22,2020-03-28,7,2020,"13",5758736,860,38,811,49,822,0.659867026375232,0.850881165589115,0.0604192355117139
"United States","Colorado","CO",2020-03-29,2020-04-04,7,2020,"14",5758736,967,82,804,163,885,1.42392358323076,2.83048224471481,0.20273631840796
"United States","Colorado","CO",2020-04-05,2020-04-11,7,2020,"15",5758736,1096,148,797,299,948,2.57000841851406,5.19211160226827,0.375156838143036
"United States","Colorado","CO",2020-04-12,2020-04-18,7,2020,"16",5758736,1106,137,790,316,969,2.37899427930018,5.48731527196246,0.4
"United States","Colorado","CO",2020-04-19,2020-04-25,7,2020,"17",5758736,1067,259,784,283,808,4.49751473239961,4.91427285432081,0.360969387755102
"United States","Colorado","CO",2020-04-26,2020-05-02,7,2020,"18",5758736,999,162,774,225,837,2.8131173229681,3.90710739301124,0.290697674418605
"United States","Colorado","CO",2020-05-03,2020-05-09,7,2020,"19",5758736,906,135,762,144,771,2.34426443580675,2.5005487315272,0.188976377952756
"United States","Colorado","CO",2020-05-10,2020-05-16,7,2020,"20",5758736,887,225,750,137,662,3.90710739301124,2.37899427930018,0.182666666666667
"United States","Colorado","CO",2020-05-17,2020-05-23,7,2020,"21",5758736,847,133,741,106,714,2.30953459231331,1.84068170515196,0.143049932523617
"United States","Colorado","CO",2020-05-24,2020-05-30,7,2020,"22",5758736,834,117,729,105,717,2.03169584436585,1.82331678340525,0.144032921810699
"United States","Colorado","CO",2020-05-31,2020-06-06,7,2020,"23",5758736,820,82,726,94,738,1.42392358323076,1.63230264419136,0.129476584022039
"United States","Colorado","CO",2020-06-07,2020-06-13,7,2020,"24",5758736,816,73,720,96,743,1.26763928751031,1.6670324876848,0.133333333333333
"United States","Colorado","CO",2020-06-14,2020-06-20,7,2020,"25",5758736,863,49,717,146,814,0.850881165589115,2.53527857502063,0.203626220362622
"United States","Colorado","CO",2020-06-21,2020-06-27,7,2020,"26",5758736,877,28,722,155,849,0.486217808908066,2.69156287074108,0.214681440443213
"United States","Colorado","CO",2020-06-28,2020-07-04,7,2020,"27",5758736,788,27,717,71,761,0.468852887161349,1.23290944401688,0.099023709902371
"United States","Colorado","CO",2020-07-05,2020-07-11,7,2020,"28",5758736,815,24,715,100,791,0.416758121921199,1.73649217467166,0.13986013986014
"United States","Colorado","CO",2020-07-12,2020-07-18,7,2020,"29",5758736,808,27,718,90,781,0.468852887161349,1.5628429572045,0.125348189415042
"United States","Colorado","CO",2020-07-19,2020-07-25,7,2020,"30",5758736,833,42,718,115,791,0.729326713362099,1.99696600087241,0.16016713091922
"United States","Colorado","CO",2020-07-26,2020-08-01,7,2020,"31",5758736,813,50,712,101,763,0.868246087335832,1.75385709641838,0.14185393258427
"United States","Colorado","CO",2020-08-02,2020-08-08,7,2020,"32",5758736,841,13,719,122,828,0.225743982707316,2.11852045309943,0.169680111265647
"United States","Colorado","CO",2020-08-09,2020-08-15,7,2020,"33",5758736,836,39,725,111,797,0.677231948121949,1.92750631388555,0.153103448275862
"United States","Colorado","CO",2020-08-16,2020-08-22,7,2020,"34",5758736,863,22,726,137,841,0.382028278427766,2.37899427930018,0.18870523415978
"United States","Colorado","CO",2020-08-23,2020-08-29,7,2020,"35",5758736,817,26,725,92,791,0.451487965414633,1.59757280069793,0.126896551724138
"United States","Colorado","CO",2020-08-30,2020-09-05,7,2020,"36",5758736,743,22,729,14,721,0.382028278427766,0.243108904454033,0.01920438957476
"United States","Colorado","CO",2020-09-06,2020-09-12,7,2020,"37",5758736,850,22,731,119,828,0.382028278427766,2.06642568785928,0.162790697674419
"United States","Colorado","CO",2020-09-13,2020-09-19,7,2020,"38",5758736,804,25,736,68,779,0.434123043667916,1.18081467877673,0.0923913043478262
"United States","Colorado","CO",2020-09-20,2020-09-26,7,2020,"39",5758736,838,27,745,93,811,0.468852887161349,1.61493772244465,0.124832214765101
"United States","Colorado","CO",2020-09-27,2020-10-03,7,2020,"40",5758736,782,17,752,30,765,0.295203669694183,0.520947652401499,0.0398936170212767
"United States","Colorado","CO",2020-10-04,2020-10-10,7,2020,"41",5758736,801,55,751,50,746,0.955070696069415,0.868246087335832,0.066577896138482
"United States","Colorado","CO",2020-10-11,2020-10-17,7,2020,"42",5758736,867,64,763,104,803,1.11135499178986,1.80595186165853,0.136304062909568
"United States","Colorado","CO",2020-10-18,2020-10-24,7,2020,"43",5758736,869,42,756,113,827,0.729326713362099,1.96223615737898,0.1494708994709
"United States","Colorado","CO",2020-10-25,2020-10-31,7,2020,"44",5758736,907,58,758,149,849,1.00716546130957,2.58737334026078,0.196569920844327
"United States","Colorado","CO",2020-11-01,2020-11-07,7,2020,"45",5758736,1007,111,760,247,896,1.92750631388555,4.28913567143901,0.325
"United States","Colorado","CO",2020-11-08,2020-11-14,7,2020,"46",5758736,1040,137,765,275,903,2.37899427930018,4.77535348034708,0.359477124183007
"United States","Colorado","CO",2020-11-15,2020-11-21,7,2020,"47",5758736,1132,263,760,372,869,4.56697441938648,6.45975088977859,0.489473684210526
"United States","Colorado","CO",2020-11-22,2020-11-28,7,2020,"48",5758736,1216,196,775,441,1020,3.40352466235646,7.65793049030204,0.569032258064516
"United States","Colorado","CO",2020-11-29,2020-12-05,7,2020,"49",5758736,1256,373,775,481,883,6.47711581152531,8.3525273601707,0.620645161290323
"United States","Colorado","CO",2020-12-06,2020-12-12,7,2020,"50",5758736,1258,515,775,483,743,8.94293469955907,8.38725720366414,0.623225806451613
"United States","Colorado","CO",2020-12-13,2020-12-19,7,2020,"51",5758736,1201,468,792,409,733,8.12678337746339,7.10225299440711,0.516414141414141
"United States","Colorado","CO",2020-12-20,2020-12-26,7,2020,"52",5758736,1100,253,816,284,847,4.39332520191931,4.93163777606753,0.348039215686275
"United States","Colorado","CO",2020-12-27,2021-01-02,7,2020,"53",5758736,1098,320,836,262,778,5.55677495894933,4.54960949763976,0.313397129186603
"United States","Colorado","CO",2021-01-03,2021-01-09,7,2021,"1",5758736,1082,278,842,240,804,4.82744824558723,4.16758121921199,0.285035629453682
"United States","Colorado","CO",2021-01-10,2021-01-16,7,2021,"2",5758736,1007,167,844,163,840,2.89994193170168,2.83048224471481,0.193127962085308
"United States","Colorado","CO",2021-01-17,2021-01-23,7,2021,"3",5758736,985,123,847,138,862,2.13588537484615,2.3963592010469,0.162927981109799
"United States","Colorado","CO",2021-01-24,2021-01-30,7,2021,"4",5758736,941,136,847,94,805,2.36162935755346,1.63230264419136,0.110979929161747
"United States","Colorado","CO",2021-01-31,2021-02-06,7,2021,"5",5758736,954,106,841,113,848,1.84068170515196,1.96223615737898,0.13436385255648
"United States","Colorado","CO",2021-02-07,2021-02-13,7,2021,"6",5758736,855,97,844,11,758,1.68439740943151,0.191014139213883,0.0130331753554502
"United States","Colorado","CO",2021-02-14,2021-02-20,7,2021,"7",5758736,899,75,841,58,824,1.30236913100375,1.00716546130957,0.0689655172413792
"United States","Colorado","CO",2021-02-21,2021-02-27,7,2021,"8",5758736,878,62,843,35,816,1.07662514829643,0.607772261135082,0.0415183867141162
"United States","Colorado","CO",2021-02-28,2021-03-06,7,2021,"9",5758736,866,40,836,30,826,0.694596869868666,0.520947652401499,0.0358851674641147
"United States","Colorado","CO",2021-03-07,2021-03-13,7,2021,"10",5758736,847,53,830,17,794,0.920340852575982,0.295203669694183,0.0204819277108435
"United States","Colorado","CO",2021-03-14,2021-03-20,7,2021,"11",5758736,905,27,822,83,878,0.468852887161349,1.44128850497748,0.100973236009732
"United States","Colorado","CO",2021-03-21,2021-03-27,7,2021,"12",5758736,892,27,819,73,865,0.468852887161349,1.26763928751031,0.089133089133089
"United States","Colorado","CO",2021-03-28,2021-04-03,7,2021,"13",5758736,842,30,814,28,812,0.520947652401499,0.486217808908066,0.0343980343980343
"United States","Colorado","CO",2021-04-04,2021-04-10,7,2021,"14",5758736,811,23,812,-1,788,0.399393200174483,-0.0173649217467166,-0.00123152709359609
"United States","Colorado","CO",2021-04-11,2021-04-17,7,2021,"15",5758736,875,33,802,73,842,0.573042417641649,1.26763928751031,0.0910224438902743
"United States","Colorado","CO",2021-04-18,2021-04-24,7,2021,"16",5758736,841,61,795,46,780,1.05926022654972,0.798786400348965,0.0578616352201258
"United States","Colorado","CO",2021-04-25,2021-05-01,7,2021,"17",5758736,849,53,789,60,796,0.920340852575982,1.041895304803,0.0760456273764258
"United States","Colorado","CO",2021-05-02,2021-05-08,7,2021,"18",5758736,854,53,782,72,801,0.920340852575982,1.2502743657636,0.092071611253197
"United States","Colorado","CO",2021-05-09,2021-05-15,7,2021,"19",5758736,879,87,787,92,792,1.51074819196435,1.59757280069793,0.116899618805591
"United States","Colorado","CO",2021-05-16,2021-05-22,7,2021,"20",5758736,850,61,781,69,789,1.05926022654972,1.19817960052345,0.0883482714468631
"United States","Colorado","CO",2021-05-23,2021-05-29,7,2021,"21",5758736,821,73,775,46,748,1.26763928751031,0.798786400348965,0.0593548387096774
"United States","Colorado","CO",2021-05-30,2021-06-05,7,2021,"22",5758736,830,37,766,64,793,0.642502104628516,1.11135499178986,0.0835509138381201
"United States","Colorado","CO",2021-06-06,2021-06-12,7,2021,"23",5758736,886,75,762,124,811,1.30236913100375,2.15325029659286,0.162729658792651
"United States","Colorado","CO",2021-06-13,2021-06-19,7,2021,"24",5758736,828,44,755,73,784,0.764056556855532,1.26763928751031,0.0966887417218543
"United States","Colorado","CO",2021-06-20,2021-06-26,7,2021,"25",5758736,778,38,745,33,740,0.659867026375232,0.573042417641649,0.0442953020134229
"United States","Colorado","CO",2021-06-27,2021-07-03,7,2021,"26",5758736,778,44,742,36,734,0.764056556855532,0.625137182881799,0.0485175202156334
"United States","Colorado","CO",2021-07-04,2021-07-10,7,2021,"27",5758736,648,23,735,-87,625,0.399393200174483,-1.51074819196435,-0.118367346938775
"United States","Connecticut","CT",2019-12-29,2020-01-04,7,2020,"1",3565287,633,0,683,-50,633,0,-1.40241164315804,-0.0732064421669106
"United States","Connecticut","CT",2020-01-05,2020-01-11,7,2020,"2",3565287,631,0,684,-53,631,0,-1.48655634174752,-0.077485380116959
"United States","Connecticut","CT",2020-01-12,2020-01-18,7,2020,"3",3565287,639,0,683,-44,639,0,-1.23412224597908,-0.0644216691068814
"United States","Connecticut","CT",2020-01-19,2020-01-25,7,2020,"4",3565287,653,0,687,-34,653,0,-0.953639917347467,-0.049490538573508
"United States","Connecticut","CT",2020-01-26,2020-02-01,7,2020,"5",3565287,686,0,686,0,686,0,0,0
"United States","Connecticut","CT",2020-02-02,2020-02-08,7,2020,"6",3565287,652,0,679,-27,652,0,-0.757302287305342,-0.0397643593519882
"United States","Connecticut","CT",2020-02-09,2020-02-15,7,2020,"7",3565287,635,0,663,-28,635,0,-0.785350520168502,-0.0422322775263951
"United States","Connecticut","CT",2020-02-16,2020-02-22,7,2020,"8",3565287,653,0,662,-9,653,0,-0.252434095768447,-0.013595166163142
"United States","Connecticut","CT",2020-02-23,2020-02-29,7,2020,"9",3565287,638,0,653,-15,638,0,-0.420723492947412,-0.0229709035222052
"United States","Connecticut","CT",2020-03-01,2020-03-07,7,2020,"10",3565287,625,0,648,-23,625,0,-0.645109355852699,-0.0354938271604939
"United States","Connecticut","CT",2020-03-08,2020-03-14,7,2020,"11",3565287,632,0,644,-12,632,0,-0.33657879435793,-0.0186335403726708
"United States","Connecticut","CT",2020-03-15,2020-03-21,7,2020,"12",3565287,665,5,639,26,660,0.140241164315804,0.729254054442181,0.0406885758998434
"United States","Connecticut","CT",2020-03-22,2020-03-28,7,2020,"13",3565287,751,28,648,103,723,0.785350520168502,2.88896798490556,0.158950617283951
"United States","Connecticut","CT",2020-03-29,2020-04-04,7,2020,"14",3565287,891,132,649,242,759,3.70236673793723,6.78767235288491,0.372881355932203
"United States","Connecticut","CT",2020-04-05,2020-04-11,7,2020,"15",3565287,1260,329,652,608,931,9.22786861197991,17.0533255808018,0.932515337423313
"United States","Connecticut","CT",2020-04-12,2020-04-18,7,2020,"16",3565287,1389,592,645,744,797,16.6045538549912,20.8678852501916,1.15348837209302
"United States","Connecticut","CT",2020-04-19,2020-04-25,7,2020,"17",3565287,1338,775,631,707,563,21.7373804689496,19.8301006342547,1.12044374009509
"United States","Connecticut","CT",2020-04-26,2020-05-02,7,2020,"18",3565287,1165,575,615,550,590,16.1277338963175,15.4265280747384,0.894308943089431
"United States","Connecticut","CT",2020-05-03,2020-05-09,7,2020,"19",3565287,1052,496,604,448,556,13.9119235001278,12.565608322696,0.741721854304636
"United States","Connecticut","CT",2020-05-10,2020-05-16,7,2020,"20",3565287,954,406,588,366,548,11.3875825424433,10.2656532279169,0.622448979591837
"United States","Connecticut","CT",2020-05-17,2020-05-23,7,2020,"21",3565287,823,336,584,239,487,9.42420624202203,6.70352765429543,0.409246575342466
"United States","Connecticut","CT",2020-05-24,2020-05-30,7,2020,"22",3565287,759,238,583,176,521,6.67547942143227,4.9364889839163,0.30188679245283
"United States","Connecticut","CT",2020-05-31,2020-06-06,7,2020,"23",3565287,669,143,584,85,526,4.01089729943199,2.38409979336867,0.14554794520548
"United States","Connecticut","CT",2020-06-07,2020-06-13,7,2020,"24",3565287,636,131,584,52,505,3.67431850507407,1.45850810888436,0.0890410958904109
"United States","Connecticut","CT",2020-06-14,2020-06-20,7,2020,"25",3565287,581,65,585,-4,516,1.82313513610545,-0.112192931452643,-0.00683760683760681
"United States","Connecticut","CT",2020-06-21,2020-06-27,7,2020,"26",3565287,598,60,579,19,538,1.68289397178965,0.532916424400055,0.0328151986183074
"United States","Connecticut","CT",2020-06-28,2020-07-04,7,2020,"27",3565287,553,24,580,-27,529,0.673157588715859,-0.757302287305342,-0.0465517241379311
"United States","Connecticut","CT",2020-07-05,2020-07-11,7,2020,"28",3565287,611,13,578,33,598,0.36462702722109,0.925591684484307,0.0570934256055364
"United States","Connecticut","CT",2020-07-12,2020-07-18,7,2020,"29",3565287,569,48,571,-2,521,1.34631517743172,-0.0560964657263216,-0.00350262697022763
"United States","Connecticut","CT",2020-07-19,2020-07-25,7,2020,"30",3565287,586,17,561,25,569,0.476819958673734,0.70120582157902,0.0445632798573976
"United States","Connecticut","CT",2020-07-26,2020-08-01,7,2020,"31",3565287,555,19,553,2,536,0.532916424400055,0.0560964657263216,0.00361663652802902
"United States","Connecticut","CT",2020-08-02,2020-08-08,7,2020,"32",3565287,593,9,549,44,584,0.252434095768447,1.23412224597908,0.0801457194899817
"United States","Connecticut","CT",2020-08-09,2020-08-15,7,2020,"33",3565287,574,12,547,27,562,0.33657879435793,0.757302287305342,0.0493601462522852
"United States","Connecticut","CT",2020-08-16,2020-08-22,7,2020,"34",3565287,571,7,548,23,564,0.196337630042126,0.645109355852699,0.0419708029197081
"United States","Connecticut","CT",2020-08-23,2020-08-29,7,2020,"35",3565287,532,5,544,-12,527,0.140241164315804,-0.33657879435793,-0.0220588235294118
"United States","Connecticut","CT",2020-08-30,2020-09-05,7,2020,"36",3565287,574,3,552,22,571,0.0841446985894824,0.617061122989538,0.0398550724637681
"United States","Connecticut","CT",2020-09-06,2020-09-12,7,2020,"37",3565287,571,12,554,17,559,0.33657879435793,0.476819958673734,0.0306859205776173
"United States","Connecticut","CT",2020-09-13,2020-09-19,7,2020,"38",3565287,579,12,557,22,567,0.33657879435793,0.617061122989538,0.0394973070017954
"United States","Connecticut","CT",2020-09-20,2020-09-26,7,2020,"39",3565287,644,9,569,75,635,0.252434095768447,2.10361746473706,0.131810193321617
"United States","Connecticut","CT",2020-09-27,2020-10-03,7,2020,"40",3565287,623,12,572,51,611,0.33657879435793,1.4304598760212,0.0891608391608392
"United States","Connecticut","CT",2020-10-04,2020-10-10,7,2020,"41",3565287,637,17,578,59,620,0.476819958673734,1.65484573892649,0.102076124567474
"United States","Connecticut","CT",2020-10-11,2020-10-17,7,2020,"42",3565287,619,12,580,39,607,0.33657879435793,1.09388108166327,0.0672413793103448
"United States","Connecticut","CT",2020-10-18,2020-10-24,7,2020,"43",3565287,683,35,587,96,648,0.981688150210628,2.69263035486344,0.163543441226576
"United States","Connecticut","CT",2020-10-25,2020-10-31,7,2020,"44",3565287,639,38,593,46,601,1.06583284880011,1.2902187117054,0.0775716694772344
"United States","Connecticut","CT",2020-11-01,2020-11-07,7,2020,"45",3565287,727,55,599,128,672,1.54265280747384,3.59017380648458,0.213689482470785
"United States","Connecticut","CT",2020-11-08,2020-11-14,7,2020,"46",3565287,685,67,604,81,618,1.87923160183177,2.27190686191603,0.134105960264901
"United States","Connecticut","CT",2020-11-15,2020-11-21,7,2020,"47",3565287,759,91,613,146,668,2.55238919054763,4.09504199802148,0.238172920065253
"United States","Connecticut","CT",2020-11-22,2020-11-28,7,2020,"48",3565287,757,133,624,133,624,3.73041497080039,3.73041497080039,0.213141025641026
"United States","Connecticut","CT",2020-11-29,2020-12-05,7,2020,"49",3565287,844,185,633,211,659,5.18892307968475,5.91817713412693,0.333333333333333
"United States","Connecticut","CT",2020-12-06,2020-12-12,7,2020,"50",3565287,846,217,636,210,629,6.08646653130589,5.89012890126377,0.330188679245283
"United States","Connecticut","CT",2020-12-13,2020-12-19,7,2020,"51",3565287,871,218,640,231,653,6.11451476416905,6.47914179139015,0.3609375
"United States","Connecticut","CT",2020-12-20,2020-12-26,7,2020,"52",3565287,920,210,648,272,710,5.89012890126377,7.62911933877974,0.419753086419753
"United States","Connecticut","CT",2020-12-27,2021-01-02,7,2020,"53",3565287,912,308,647,265,604,8.63885572185353,7.43278170873761,0.409582689335394
"United States","Connecticut","CT",2021-01-03,2021-01-09,7,2021,"1",3565287,849,225,658,191,624,6.31085239421118,5.35721247686371,0.290273556231003
"United States","Connecticut","CT",2021-01-10,2021-01-16,7,2021,"2",3565287,860,269,663,197,591,7.54497464019026,5.52550187404268,0.297134238310709
"United States","Connecticut","CT",2021-01-17,2021-01-23,7,2021,"3",3565287,853,226,674,179,627,6.33890062707434,5.02063368250578,0.265578635014837
"United States","Connecticut","CT",2021-01-24,2021-01-30,7,2021,"4",3565287,819,227,677,142,592,6.3669488599375,3.98284906656883,0.209748892171344
"United States","Connecticut","CT",2021-01-31,2021-02-06,7,2021,"5",3565287,773,168,681,92,605,4.71210312101102,2.58043742341079,0.135095447870778
"United States","Connecticut","CT",2021-02-07,2021-02-13,7,2021,"6",3565287,723,167,670,53,556,4.68405488814785,1.48655634174752,0.0791044776119403
"United States","Connecticut","CT",2021-02-14,2021-02-20,7,2021,"7",3565287,683,142,665,18,541,3.98284906656883,0.504868191536894,0.0270676691729324
"United States","Connecticut","CT",2021-02-21,2021-02-27,7,2021,"8",3565287,676,104,660,16,572,2.91701621776872,0.448771725810573,0.0242424242424242
"United States","Connecticut","CT",2021-02-28,2021-03-06,7,2021,"9",3565287,651,77,653,-2,574,2.15971393046338,-0.0560964657263216,-0.00306278713629404
"United States","Connecticut","CT",2021-03-07,2021-03-13,7,2021,"10",3565287,666,61,645,21,605,1.71094220465281,0.589012890126377,0.0325581395348837
"United States","Connecticut","CT",2021-03-14,2021-03-20,7,2021,"11",3565287,666,68,643,23,598,1.90727983469493,0.645109355852699,0.0357698289269051
"United States","Connecticut","CT",2021-03-21,2021-03-27,7,2021,"12",3565287,724,36,649,75,688,1.00973638307379,2.10361746473706,0.115562403697997
"United States","Connecticut","CT",2021-03-28,2021-04-03,7,2021,"13",3565287,711,37,646,65,674,1.03778461593695,1.82313513610545,0.10061919504644
"United States","Connecticut","CT",2021-04-04,2021-04-10,7,2021,"14",3565287,677,38,636,41,639,1.06583284880011,1.14997754738959,0.0644654088050314
"United States","Connecticut","CT",2021-04-11,2021-04-17,7,2021,"15",3565287,718,51,640,78,667,1.4304598760212,2.18776216332654,0.121875
"United States","Connecticut","CT",2021-04-18,2021-04-24,7,2021,"16",3565287,714,52,626,88,662,1.45850810888436,2.46824449195815,0.140575079872205
"United States","Connecticut","CT",2021-04-25,2021-05-01,7,2021,"17",3565287,740,50,609,131,690,1.40241164315804,3.67431850507407,0.215106732348112
"United States","Connecticut","CT",2021-05-02,2021-05-08,7,2021,"18",3565287,713,40,595,118,673,1.12192931452643,3.30969147785297,0.198319327731092
"United States","Connecticut","CT",2021-05-09,2021-05-15,7,2021,"19",3565287,640,36,587,53,604,1.00973638307379,1.48655634174752,0.090289608177172
"United States","Connecticut","CT",2021-05-16,2021-05-22,7,2021,"20",3565287,683,39,578,105,644,1.09388108166327,2.94506445063188,0.181660899653979
"United States","Connecticut","CT",2021-05-23,2021-05-29,7,2021,"21",3565287,721,26,575,146,695,0.729254054442181,4.09504199802148,0.253913043478261
"United States","Connecticut","CT",2021-05-30,2021-06-05,7,2021,"22",3565287,535,8,567,-32,527,0.224385862905286,-0.897543451621146,-0.0564373897707231
"United States","Connecticut","CT",2021-06-06,2021-06-12,7,2021,"23",3565287,474,15,574,-100,459,0.420723492947412,-2.80482328631608,-0.174216027874564
"United States","Connecticut","CT",2021-06-13,2021-06-19,7,2021,"24",3565287,362,9,577,-215,353,0.252434095768447,-6.03037006557957,-0.37261698440208
"United States","Delaware","DE",2019-12-29,2020-01-04,7,2020,"1",973764,199,0,216,-17,199,0,-1.74580288447714,-0.0787037037037037
"United States","Delaware","DE",2020-01-05,2020-01-11,7,2020,"2",973764,194,0,214,-20,194,0,-2.0538857464437,-0.0934579439252337
"United States","Delaware","DE",2020-01-12,2020-01-18,7,2020,"3",973764,190,0,217,-27,190,0,-2.77274575769899,-0.124423963133641
"United States","Delaware","DE",2020-01-19,2020-01-25,7,2020,"4",973764,190,0,213,-23,190,0,-2.36196860841025,-0.107981220657277
"United States","Delaware","DE",2020-01-26,2020-02-01,7,2020,"5",973764,183,0,213,-30,183,0,-3.08082861966555,-0.140845070422535
"United States","Delaware","DE",2020-02-02,2020-02-08,7,2020,"6",973764,191,0,210,-19,191,0,-1.95119145912151,-0.0904761904761905
"United States","Delaware","DE",2020-02-09,2020-02-15,7,2020,"7",973764,202,0,206,-4,202,0,-0.410777149288739,-0.0194174757281553
"United States","Delaware","DE",2020-02-16,2020-02-22,7,2020,"8",973764,194,0,204,-10,194,0,-1.02694287322185,-0.0490196078431373
"United States","Delaware","DE",2020-02-23,2020-02-29,7,2020,"9",973764,164,0,202,-38,164,0,-3.90238291824302,-0.188118811881188
"United States","Delaware","DE",2020-03-01,2020-03-07,7,2020,"10",973764,200,0,203,-3,200,0,-0.308082861966554,-0.0147783251231527
"United States","Delaware","DE",2020-03-08,2020-03-14,7,2020,"11",973764,189,0,204,-15,189,0,-1.54041430983277,-0.0735294117647058
"United States","Delaware","DE",2020-03-15,2020-03-21,7,2020,"12",973764,221,0,207,14,221,0,1.43772002251059,0.067632850241546
"United States","Delaware","DE",2020-03-22,2020-03-28,7,2020,"13",973764,188,5,206,-18,183,0.513471436610924,-1.84849717179933,-0.087378640776699
"United States","Delaware","DE",2020-03-29,2020-04-04,7,2020,"14",973764,214,9,209,5,205,0.924248585899664,0.513471436610924,0.0239234449760766
"United States","Delaware","DE",2020-04-05,2020-04-11,7,2020,"15",973764,219,19,207,12,200,1.95119145912151,1.23233144786622,0.0579710144927537
"United States","Delaware","DE",2020-04-12,2020-04-18,7,2020,"16",973764,229,34,196,33,195,3.49160576895428,3.3889114816321,0.168367346938775
"United States","Delaware","DE",2020-04-19,2020-04-25,7,2020,"17",973764,285,45,189,96,240,4.62124292949832,9.85865158292974,0.507936507936508
"United States","Delaware","DE",2020-04-26,2020-05-02,7,2020,"18",973764,251,56,185,66,195,5.75088009004235,6.7778229632642,0.356756756756757
"United States","Delaware","DE",2020-05-03,2020-05-09,7,2020,"19",973764,271,34,182,89,237,3.49160576895428,9.13979157167445,0.489010989010989
"United States","Delaware","DE",2020-05-10,2020-05-16,7,2020,"20",973764,276,84,177,99,192,8.62632013506353,10.1667344448963,0.559322033898305
"United States","Delaware","DE",2020-05-17,2020-05-23,7,2020,"21",973764,222,38,177,45,184,3.90238291824302,4.62124292949832,0.254237288135593
"United States","Delaware","DE",2020-05-24,2020-05-30,7,2020,"22",973764,226,37,177,49,189,3.79968863092084,5.03202007878706,0.27683615819209
"United States","Delaware","DE",2020-05-31,2020-06-06,7,2020,"23",973764,182,29,176,6,153,2.97813433234336,0.616165723933109,0.0340909090909092
"United States","Delaware","DE",2020-06-07,2020-06-13,7,2020,"24",973764,200,29,175,25,171,2.97813433234336,2.56735718305462,0.142857142857143
"United States","Delaware","DE",2020-06-14,2020-06-20,7,2020,"25",973764,162,15,182,-20,147,1.54041430983277,-2.0538857464437,-0.10989010989011
"United States","Delaware","DE",2020-06-21,2020-06-27,7,2020,"26",973764,201,73,178,23,128,7.49668297451949,2.36196860841025,0.129213483146067
"United States","Delaware","DE",2020-06-28,2020-07-04,7,2020,"27",973764,201,5,178,23,196,0.513471436610924,2.36196860841025,0.129213483146067
"United States","Delaware","DE",2020-07-05,2020-07-11,7,2020,"28",973764,194,3,179,15,191,0.308082861966554,1.54041430983277,0.0837988826815643
"United States","Delaware","DE",2020-07-12,2020-07-18,7,2020,"29",973764,191,8,176,15,183,0.821554298577479,1.54041430983277,0.0852272727272727
"United States","Delaware","DE",2020-07-19,2020-07-25,7,2020,"30",973764,201,56,174,27,145,5.75088009004235,2.77274575769899,0.155172413793103
"United States","Delaware","DE",2020-07-26,2020-08-01,7,2020,"31",973764,195,6,176,19,189,0.616165723933109,1.95119145912151,0.107954545454545
"United States","Delaware","DE",2020-08-02,2020-08-08,7,2020,"32",973764,197,5,174,23,192,0.513471436610924,2.36196860841025,0.132183908045977
"United States","Delaware","DE",2020-08-09,2020-08-15,7,2020,"33",973764,189,3,176,13,186,0.308082861966554,1.3350257351884,0.0738636363636365
"United States","Delaware","DE",2020-08-16,2020-08-22,7,2020,"34",973764,194,7,175,19,187,0.718860011255294,1.95119145912151,0.108571428571429
"United States","Delaware","DE",2020-08-23,2020-08-29,7,2020,"35",973764,190,4,175,15,186,0.410777149288739,1.54041430983277,0.0857142857142856
"United States","Delaware","DE",2020-08-30,2020-09-05,7,2020,"36",973764,208,4,174,34,204,0.410777149288739,3.49160576895428,0.195402298850575
"United States","Delaware","DE",2020-09-06,2020-09-12,7,2020,"37",973764,198,5,174,24,193,0.513471436610924,2.46466289573244,0.137931034482759
"United States","Delaware","DE",2020-09-13,2020-09-19,7,2020,"38",973764,161,8,171,-10,153,0.821554298577479,-1.02694287322185,-0.0584795321637427
"United States","Delaware","DE",2020-09-20,2020-09-26,7,2020,"39",973764,202,12,175,27,190,1.23233144786622,2.77274575769899,0.154285714285714
"United States","Delaware","DE",2020-09-27,2020-10-03,7,2020,"40",973764,202,12,178,24,190,1.23233144786622,2.46466289573244,0.134831460674157
"United States","Delaware","DE",2020-10-04,2020-10-10,7,2020,"41",973764,203,8,180,23,195,0.821554298577479,2.36196860841025,0.127777777777778
"United States","Delaware","DE",2020-10-11,2020-10-17,7,2020,"42",973764,203,12,178,25,191,1.23233144786622,2.56735718305462,0.140449438202247
"United States","Delaware","DE",2020-10-18,2020-10-24,7,2020,"43",973764,215,16,180,35,199,1.64310859715496,3.59430005627647,0.194444444444444
"United States","Delaware","DE",2020-10-25,2020-10-31,7,2020,"44",973764,195,28,178,17,167,2.87544004502118,1.74580288447714,0.095505617977528
"United States","Delaware","DE",2020-11-01,2020-11-07,7,2020,"45",973764,199,7,183,16,192,0.718860011255294,1.64310859715496,0.0874316939890711
"United States","Delaware","DE",2020-11-08,2020-11-14,7,2020,"46",973764,172,20,186,-14,152,2.0538857464437,-1.43772002251059,-0.0752688172043011
"United States","Delaware","DE",2020-11-15,2020-11-21,7,2020,"47",973764,232,12,188,44,220,1.23233144786622,4.51854864217613,0.234042553191489
"United States","Delaware","DE",2020-11-22,2020-11-28,7,2020,"48",973764,199,21,188,11,178,2.15658003376588,1.12963716054403,0.0585106382978724
"United States","Delaware","DE",2020-11-29,2020-12-05,7,2020,"49",973764,231,24,185,46,207,2.46466289573244,4.7239372168205,0.248648648648649
"United States","Delaware","DE",2020-12-06,2020-12-12,7,2020,"50",973764,277,22,189,88,255,2.25927432108807,9.03709728435227,0.465608465608466
"United States","Delaware","DE",2020-12-13,2020-12-19,7,2020,"51",973764,281,43,190,91,238,4.41585435485395,9.34518014631882,0.478947368421053
"United States","Delaware","DE",2020-12-20,2020-12-26,7,2020,"52",973764,289,36,198,91,253,3.69699434359865,9.34518014631882,0.45959595959596
"United States","Delaware","DE",2020-12-27,2021-01-02,7,2020,"53",973764,285,36,199,86,249,3.69699434359865,8.8317087097079,0.432160804020101
"United States","Delaware","DE",2021-01-03,2021-01-09,7,2021,"1",973764,276,39,200,76,237,4.00507720556521,7.80476583648605,0.38
"United States","Delaware","DE",2021-01-10,2021-01-16,7,2021,"2",973764,287,47,199,88,240,4.82663150414269,9.03709728435227,0.442211055276382
"United States","Delaware","DE",2021-01-17,2021-01-23,7,2021,"3",973764,282,20,199,83,262,2.0538857464437,8.52362584774134,0.417085427135678
"United States","Delaware","DE",2021-01-24,2021-01-30,7,2021,"4",973764,273,45,196,77,228,4.62124292949832,7.90746012380823,0.392857142857143
"United States","Delaware","DE",2021-01-31,2021-02-06,7,2021,"5",973764,269,121,198,71,148,12.4260087659844,7.29129439987512,0.358585858585859
"United States","Delaware","DE",2021-02-07,2021-02-13,7,2021,"6",973764,241,80,196,45,161,8.21554298577479,4.62124292949832,0.229591836734694
"United States","Delaware","DE",2021-02-14,2021-02-20,7,2021,"7",973764,211,84,194,17,127,8.62632013506353,1.74580288447714,0.0876288659793814
"United States","Delaware","DE",2021-02-21,2021-02-27,7,2021,"8",973764,219,56,194,25,163,5.75088009004235,2.56735718305462,0.128865979381443
"United States","Delaware","DE",2021-02-28,2021-03-06,7,2021,"9",973764,223,42,193,30,181,4.31316006753176,3.08082861966555,0.155440414507772
"United States","Delaware","DE",2021-03-07,2021-03-13,7,2021,"10",973764,173,32,193,-20,141,3.28621719430991,-2.0538857464437,-0.103626943005181
"United States","Delaware","DE",2021-03-14,2021-03-20,7,2021,"11",973764,214,26,192,22,188,2.67005147037681,2.25927432108807,0.114583333333333
"United States","Delaware","DE",2021-03-21,2021-03-27,7,2021,"12",973764,205,22,186,19,183,2.25927432108807,1.95119145912151,0.102150537634409
"United States","Delaware","DE",2021-03-28,2021-04-03,7,2021,"13",973764,158,22,189,-31,136,2.25927432108807,-3.18352290698773,-0.164021164021164
"United States","Delaware","DE",2021-04-04,2021-04-10,7,2021,"14",973764,194,7,191,3,187,0.718860011255294,0.308082861966554,0.0157068062827226
"United States","Delaware","DE",2021-04-11,2021-04-17,7,2021,"15",973764,211,29,186,25,182,2.97813433234336,2.56735718305462,0.134408602150538
"United States","Delaware","DE",2021-04-18,2021-04-24,7,2021,"16",973764,213,13,177,36,200,1.3350257351884,3.69699434359865,0.203389830508474
"United States","Delaware","DE",2021-04-25,2021-05-01,7,2021,"17",973764,186,11,180,6,175,1.12963716054403,0.616165723933109,0.0333333333333334
"United States","Delaware","DE",2021-05-02,2021-05-08,7,2021,"18",973764,181,10,177,4,171,1.02694287322185,0.410777149288739,0.0225988700564972
"United States","Delaware","DE",2021-05-09,2021-05-15,7,2021,"19",973764,203,15,176,27,188,1.54041430983277,2.77274575769899,0.153409090909091
"United States","Delaware","DE",2021-05-16,2021-05-22,7,2021,"20",973764,204,8,174,30,196,0.821554298577479,3.08082861966555,0.172413793103448
"United States","Delaware","DE",2021-05-23,2021-05-29,7,2021,"21",973764,180,2,176,4,178,0.20538857464437,0.410777149288739,0.0227272727272727
"United States","Delaware","DE",2021-05-30,2021-06-05,7,2021,"22",973764,137,16,174,-37,121,1.64310859715496,-3.79968863092084,-0.21264367816092
"United States","Delaware","DE",2021-06-06,2021-06-12,7,2021,"23",973764,88,2,170,-82,86,0.20538857464437,-8.42093156041916,-0.482352941176471
"United States","Delaware","DE",2021-06-13,2021-06-19,7,2021,"24",973764,137,0,170,-33,137,0,-3.3889114816321,-0.194117647058824
"United States","Delaware","DE",2021-06-20,2021-06-26,7,2021,"25",973764,207,14,173,34,193,1.43772002251059,3.49160576895428,0.196531791907514
"United States","Delaware","DE",2021-06-27,2021-07-03,7,2021,"26",973764,164,2,173,-9,162,0.20538857464437,-0.924248585899664,-0.0520231213872833
"United States","Delaware","DE",2021-07-04,2021-07-10,7,2021,"27",973764,130,0,174,-44,130,0,-4.51854864217613,-0.252873563218391
"United States","District of Columbia","DC",2019-12-29,2020-01-04,7,2020,"1",705749,132,0,136,-4,132,0,-0.56677373967232,-0.0294117647058824
"United States","District of Columbia","DC",2020-01-05,2020-01-11,7,2020,"2",705749,128,0,133,-5,128,0,-0.7084671745904,-0.0375939849624061
"United States","District of Columbia","DC",2020-01-12,2020-01-18,7,2020,"3",705749,140,0,134,6,140,0,0.85016060950848,0.044776119402985
"United States","District of Columbia","DC",2020-01-19,2020-01-25,7,2020,"4",705749,131,0,133,-2,131,0,-0.28338686983616,-0.0150375939849624
"United States","District of Columbia","DC",2020-01-26,2020-02-01,7,2020,"5",705749,143,0,131,12,143,0,1.70032121901696,0.0916030534351144
"United States","District of Columbia","DC",2020-02-02,2020-02-08,7,2020,"6",705749,131,0,130,1,131,0,0.14169343491808,0.00769230769230766
"United States","District of Columbia","DC",2020-02-09,2020-02-15,7,2020,"7",705749,122,0,129,-7,122,0,-0.99185404442656,-0.0542635658914729
"United States","District of Columbia","DC",2020-02-16,2020-02-22,7,2020,"8",705749,104,0,127,-23,104,0,-3.25894900311584,-0.181102362204724
"United States","District of Columbia","DC",2020-02-23,2020-02-29,7,2020,"9",705749,135,0,125,10,135,0,1.4169343491808,0.0800000000000001
"United States","District of Columbia","DC",2020-03-01,2020-03-07,7,2020,"10",705749,118,0,123,-5,118,0,-0.7084671745904,-0.040650406504065
"United States","District of Columbia","DC",2020-03-08,2020-03-14,7,2020,"11",705749,114,0,125,-11,114,0,-1.55862778409888,-0.088
"United States","District of Columbia","DC",2020-03-15,2020-03-21,7,2020,"12",705749,129,1,125,4,128,0.14169343491808,0.56677373967232,0.032
"United States","District of Columbia","DC",2020-03-22,2020-03-28,7,2020,"13",705749,130,4,124,6,126,0.56677373967232,0.85016060950848,0.0483870967741935
"United States","District of Columbia","DC",2020-03-29,2020-04-04,7,2020,"14",705749,156,16,120,36,140,2.26709495868928,5.10096365705088,0.3
"United States","District of Columbia","DC",2020-04-05,2020-04-11,7,2020,"15",705749,194,1,124,70,193,0.14169343491808,9.9185404442656,0.564516129032258
"United States","District of Columbia","DC",2020-04-12,2020-04-18,7,2020,"16",705749,202,69,124,78,133,9.77684700934752,11.0520879236102,0.629032258064516
"United States","District of Columbia","DC",2020-04-19,2020-04-25,7,2020,"17",705749,242,74,121,121,168,10.4853141839379,17.1449056250877,1
"United States","District of Columbia","DC",2020-04-26,2020-05-02,7,2020,"18",705749,215,75,118,97,140,10.627007618856,13.7442631870538,0.822033898305085
"United States","District of Columbia","DC",2020-05-03,2020-05-09,7,2020,"19",705749,214,71,119,95,143,10.0602338791837,13.4608763172176,0.798319327731092
"United States","District of Columbia","DC",2020-05-10,2020-05-16,7,2020,"20",705749,185,64,114,71,121,9.06837983475712,10.0602338791837,0.62280701754386
"United States","District of Columbia","DC",2020-05-17,2020-05-23,7,2020,"21",705749,181,52,112,69,129,7.36805861574016,9.77684700934752,0.616071428571429
"United States","District of Columbia","DC",2020-05-24,2020-05-30,7,2020,"22",705749,169,35,113,56,134,4.9592702221328,7.93483235541248,0.495575221238938
"United States","District of Columbia","DC",2020-05-31,2020-06-06,7,2020,"23",705749,149,21,112,37,128,2.97556213327968,5.24265709196896,0.330357142857143
"United States","District of Columbia","DC",2020-06-07,2020-06-13,7,2020,"24",705749,147,28,111,36,119,3.96741617770624,5.10096365705088,0.324324324324324
"United States","District of Columbia","DC",2020-06-14,2020-06-20,7,2020,"25",705749,132,20,112,20,112,2.8338686983616,2.8338686983616,0.178571428571429
"United States","District of Columbia","DC",2020-06-21,2020-06-27,7,2020,"26",705749,130,17,110,20,113,2.40878839360736,2.8338686983616,0.181818181818182
"United States","District of Columbia","DC",2020-06-28,2020-07-04,7,2020,"27",705749,122,9,108,14,113,1.27524091426272,1.98370808885312,0.12962962962963
"United States","District of Columbia","DC",2020-07-05,2020-07-11,7,2020,"28",705749,138,11,109,29,127,1.55862778409888,4.10910961262432,0.26605504587156
"United States","District of Columbia","DC",2020-07-12,2020-07-18,7,2020,"29",705749,121,10,110,11,111,1.4169343491808,1.55862778409888,0.1
"United States","District of Columbia","DC",2020-07-19,2020-07-25,7,2020,"30",705749,123,3,105,18,120,0.42508030475424,2.55048182852544,0.171428571428571
"United States","District of Columbia","DC",2020-07-26,2020-08-01,7,2020,"31",705749,130,4,107,23,126,0.56677373967232,3.25894900311584,0.214953271028037
"United States","District of Columbia","DC",2020-08-02,2020-08-08,7,2020,"32",705749,118,5,105,13,113,0.7084671745904,1.84201465393504,0.123809523809524
"United States","District of Columbia","DC",2020-08-09,2020-08-15,7,2020,"33",705749,117,7,103,14,110,0.99185404442656,1.98370808885312,0.135922330097087
"United States","District of Columbia","DC",2020-08-16,2020-08-22,7,2020,"34",705749,113,7,102,11,106,0.99185404442656,1.55862778409888,0.107843137254902
"United States","District of Columbia","DC",2020-08-23,2020-08-29,7,2020,"35",705749,140,1,103,37,139,0.14169343491808,5.24265709196896,0.359223300970874
"United States","District of Columbia","DC",2020-08-30,2020-09-05,7,2020,"36",705749,143,6,102,41,137,0.85016060950848,5.80943083164128,0.401960784313725
"United States","District of Columbia","DC",2020-09-06,2020-09-12,7,2020,"37",705749,125,5,104,21,120,0.7084671745904,2.97556213327968,0.201923076923077
"United States","District of Columbia","DC",2020-09-13,2020-09-19,7,2020,"38",705749,109,0,107,2,109,0,0.28338686983616,0.0186915887850467
"United States","District of Columbia","DC",2020-09-20,2020-09-26,7,2020,"39",705749,112,8,107,5,104,1.13354747934464,0.7084671745904,0.0467289719626167
"United States","District of Columbia","DC",2020-09-27,2020-10-03,7,2020,"40",705749,138,5,109,29,133,0.7084671745904,4.10910961262432,0.26605504587156
"United States","District of Columbia","DC",2020-10-04,2020-10-10,7,2020,"41",705749,146,7,111,35,139,0.99185404442656,4.9592702221328,0.315315315315315
"United States","District of Columbia","DC",2020-10-11,2020-10-17,7,2020,"42",705749,118,5,108,10,113,0.7084671745904,1.4169343491808,0.0925925925925926
"United States","District of Columbia","DC",2020-10-18,2020-10-24,7,2020,"43",705749,105,1,106,-1,104,0.14169343491808,-0.14169343491808,-0.00943396226415094
"United States","District of Columbia","DC",2020-10-25,2020-10-31,7,2020,"44",705749,128,4,105,23,124,0.56677373967232,3.25894900311584,0.219047619047619
"United States","District of Columbia","DC",2020-11-01,2020-11-07,7,2020,"45",705749,137,8,104,33,129,1.13354747934464,4.67588335229664,0.317307692307692
"United States","District of Columbia","DC",2020-11-08,2020-11-14,7,2020,"46",705749,130,4,101,29,126,0.56677373967232,4.10910961262432,0.287128712871287
"United States","District of Columbia","DC",2020-11-15,2020-11-21,7,2020,"47",705749,135,12,103,32,123,1.70032121901696,4.53418991737856,0.310679611650486
"United States","District of Columbia","DC",2020-11-22,2020-11-28,7,2020,"48",705749,120,8,107,13,112,1.13354747934464,1.84201465393504,0.121495327102804
"United States","District of Columbia","DC",2020-11-29,2020-12-05,7,2020,"49",705749,153,17,108,45,136,2.40878839360736,6.3762045713136,0.416666666666667
"United States","District of Columbia","DC",2020-12-06,2020-12-12,7,2020,"50",705749,175,18,109,66,157,2.55048182852544,9.35176670459328,0.605504587155963
"United States","District of Columbia","DC",2020-12-13,2020-12-19,7,2020,"51",705749,144,17,110,34,127,2.40878839360736,4.81757678721472,0.309090909090909
"United States","District of Columbia","DC",2020-12-20,2020-12-26,7,2020,"52",705749,165,32,114,51,133,4.53418991737856,7.22636518082208,0.447368421052632
"United States","District of Columbia","DC",2020-12-27,2021-01-02,7,2020,"53",705749,178,30,114,64,148,4.2508030475424,9.06837983475712,0.56140350877193
"United States","District of Columbia","DC",2021-01-03,2021-01-09,7,2021,"1",705749,173,21,110,63,152,2.97556213327968,8.92668639983904,0.572727272727273
"United States","District of Columbia","DC",2021-01-10,2021-01-16,7,2021,"2",705749,171,34,112,59,137,4.81757678721472,8.35991266016672,0.526785714285714
"United States","District of Columbia","DC",2021-01-17,2021-01-23,7,2021,"3",705749,162,23,113,49,139,3.25894900311584,6.94297831098592,0.433628318584071
"United States","District of Columbia","DC",2021-01-24,2021-01-30,7,2021,"4",705749,184,39,108,76,145,5.52604396180512,10.7687010537741,0.703703703703704
"United States","District of Columbia","DC",2021-01-31,2021-02-06,7,2021,"5",705749,167,38,110,57,129,5.38435052688704,8.07652579033056,0.518181818181818
"United States","District of Columbia","DC",2021-02-07,2021-02-13,7,2021,"6",705749,156,32,108,48,124,4.53418991737856,6.80128487606784,0.444444444444444
"United States","District of Columbia","DC",2021-02-14,2021-02-20,7,2021,"7",705749,170,15,109,61,155,2.1254015237712,8.64329953000288,0.559633027522936
"United States","District of Columbia","DC",2021-02-21,2021-02-27,7,2021,"8",705749,147,11,107,40,136,1.55862778409888,5.6677373967232,0.373831775700935
"United States","District of Columbia","DC",2021-02-28,2021-03-06,7,2021,"9",705749,137,25,104,33,112,3.542335872952,4.67588335229664,0.317307692307692
"United States","District of Columbia","DC",2021-03-07,2021-03-13,7,2021,"10",705749,127,10,103,24,117,1.4169343491808,3.40064243803392,0.233009708737864
"United States","District of Columbia","DC",2021-03-14,2021-03-20,7,2021,"11",705749,148,9,107,41,139,1.27524091426272,5.80943083164128,0.383177570093458
"United States","District of Columbia","DC",2021-03-21,2021-03-27,7,2021,"12",705749,138,7,106,32,131,0.99185404442656,4.53418991737856,0.30188679245283
"United States","District of Columbia","DC",2021-03-28,2021-04-03,7,2021,"13",705749,129,14,106,23,115,1.98370808885312,3.25894900311584,0.216981132075472
"United States","District of Columbia","DC",2021-04-04,2021-04-10,7,2021,"14",705749,161,11,108,53,150,1.55862778409888,7.50975205065824,0.490740740740741
"United States","District of Columbia","DC",2021-04-11,2021-04-17,7,2021,"15",705749,124,14,111,13,110,1.98370808885312,1.84201465393504,0.117117117117117
"United States","District of Columbia","DC",2021-04-18,2021-04-24,7,2021,"16",705749,131,4,110,21,127,0.56677373967232,2.97556213327968,0.190909090909091
"United States","District of Columbia","DC",2021-04-25,2021-05-01,7,2021,"17",705749,125,7,107,18,118,0.99185404442656,2.55048182852544,0.168224299065421
"United States","District of Columbia","DC",2021-05-02,2021-05-08,7,2021,"18",705749,125,4,107,18,121,0.56677373967232,2.55048182852544,0.168224299065421
"United States","District of Columbia","DC",2021-05-09,2021-05-15,7,2021,"19",705749,126,8,106,20,118,1.13354747934464,2.8338686983616,0.188679245283019
"United States","District of Columbia","DC",2021-05-16,2021-05-22,7,2021,"20",705749,134,7,105,29,127,0.99185404442656,4.10910961262432,0.276190476190476
"United States","District of Columbia","DC",2021-05-23,2021-05-29,7,2021,"21",705749,123,7,105,18,116,0.99185404442656,2.55048182852544,0.171428571428571
"United States","District of Columbia","DC",2021-05-30,2021-06-05,7,2021,"22",705749,125,4,108,17,121,0.56677373967232,2.40878839360736,0.157407407407407
"United States","District of Columbia","DC",2021-06-06,2021-06-12,7,2021,"23",705749,139,1,105,34,138,0.14169343491808,4.81757678721472,0.323809523809524
"United States","District of Columbia","DC",2021-06-13,2021-06-19,7,2021,"24",705749,124,4,107,17,120,0.56677373967232,2.40878839360736,0.158878504672897
"United States","District of Columbia","DC",2021-06-20,2021-06-26,7,2021,"25",705749,108,0,106,2,108,0,0.28338686983616,0.0188679245283019
"United States","District of Columbia","DC",2021-06-27,2021-07-03,7,2021,"26",705749,88,0,109,-21,88,0,-2.97556213327968,-0.192660550458716
"United States","District of Columbia","DC",2021-07-04,2021-07-10,7,2021,"27",705749,105,2,111,-6,103,0.28338686983616,-0.85016060950848,-0.0540540540540541
"United States","Florida","FL",2019-12-29,2020-01-04,7,2020,"1",21477737,4341,0,4441,-100,4341,0,-0.465598400799861,-0.0225174510245441
"United States","Florida","FL",2020-01-05,2020-01-11,7,2020,"2",21477737,4410,0,4512,-102,4410,0,-0.474910368815858,-0.0226063829787234
"United States","Florida","FL",2020-01-12,2020-01-18,7,2020,"3",21477737,4385,0,4684,-299,4385,0,-1.39213921839158,-0.0638343296327925
"United States","Florida","FL",2020-01-19,2020-01-25,7,2020,"4",21477737,4387,0,4685,-298,4387,0,-1.38748323438359,-0.0636072572038421
"United States","Florida","FL",2020-01-26,2020-02-01,7,2020,"5",21477737,4419,0,4674,-255,4419,0,-1.18727592203964,-0.0545571245186136
"United States","Florida","FL",2020-02-02,2020-02-08,7,2020,"6",21477737,4385,0,4623,-238,4385,0,-1.10812419390367,-0.0514817218256544
"United States","Florida","FL",2020-02-09,2020-02-15,7,2020,"7",21477737,4358,0,4575,-217,4358,0,-1.0103485297357,-0.047431693989071
"United States","Florida","FL",2020-02-16,2020-02-22,7,2020,"8",21477737,4416,0,4519,-103,4416,0,-0.479566352823857,-0.0227926532418676
"United States","Florida","FL",2020-02-23,2020-02-29,7,2020,"9",21477737,4399,0,4511,-112,4399,0,-0.521470208895844,-0.0248281977388606
"United States","Florida","FL",2020-03-01,2020-03-07,7,2020,"10",21477737,4520,2,4498,22,4518,0.00931196801599722,0.102431648175969,0.00489106269453088
"United States","Florida","FL",2020-03-08,2020-03-14,7,2020,"11",21477737,4435,1,4473,-38,4434,0.00465598400799861,-0.176927392303947,-0.00849541694612121
"United States","Florida","FL",2020-03-15,2020-03-21,7,2020,"12",21477737,4362,7,4444,-82,4355,0.0325918880559903,-0.381790688655886,-0.0184518451845185
"United States","Florida","FL",2020-03-22,2020-03-28,7,2020,"13",21477737,4461,46,4430,31,4415,0.214175264367936,0.144335504247957,0.00699774266365694
"United States","Florida","FL",2020-03-29,2020-04-04,7,2020,"14",21477737,4497,139,4351,146,4358,0.647181777111806,0.679773665167797,0.0335555044817284
"United States","Florida","FL",2020-04-05,2020-04-11,7,2020,"15",21477737,4544,251,4311,233,4293,1.16865198600765,1.08484427386368,0.05404778473672
"United States","Florida","FL",2020-04-12,2020-04-18,7,2020,"16",21477737,4416,304,4231,185,4112,1.41541913843158,0.861357041479742,0.0437248877333964
"United States","Florida","FL",2020-04-19,2020-04-25,7,2020,"17",21477737,4555,304,4189,366,4251,1.41541913843158,1.70409014692749,0.0873716877536406
"United States","Florida","FL",2020-04-26,2020-05-02,7,2020,"18",21477737,4352,310,4141,211,4042,1.44335504247957,0.982412625687706,0.0509538758753925
"United States","Florida","FL",2020-05-03,2020-05-09,7,2020,"19",21477737,4407,349,4071,336,4058,1.62493841879151,1.56441062668753,0.0825350036845984
"United States","Florida","FL",2020-05-10,2020-05-16,7,2020,"20",21477737,4279,250,4033,246,4029,1.16399600199965,1.14537206596766,0.0609967765931068
"United States","Florida","FL",2020-05-17,2020-05-23,7,2020,"21",21477737,4360,269,4008,352,4091,1.25245969815163,1.63890637081551,0.0878243512974053
"United States","Florida","FL",2020-05-24,2020-05-30,7,2020,"22",21477737,4211,214,3983,228,3997,0.996380577711702,1.06156435382368,0.0572432839568164
"United States","Florida","FL",2020-05-31,2020-06-06,7,2020,"23",21477737,4265,242,3971,294,4023,1.12674812993566,1.36885929835159,0.0740367665575421
"United States","Florida","FL",2020-06-07,2020-06-13,7,2020,"24",21477737,4256,237,3953,303,4019,1.10346820989567,1.41076315442358,0.0766506450796862
"United States","Florida","FL",2020-06-14,2020-06-20,7,2020,"25",21477737,4408,219,3947,461,4189,1.0196604977517,2.14640862768736,0.116797567772992
"United States","Florida","FL",2020-06-21,2020-06-27,7,2020,"26",21477737,4504,246,3904,600,4258,1.14537206596766,2.79359040479916,0.153688524590164
"United States","Florida","FL",2020-06-28,2020-07-04,7,2020,"27",21477737,4725,312,3915,810,4413,1.45266701049557,3.77134704647887,0.206896551724138
"United States","Florida","FL",2020-07-05,2020-07-11,7,2020,"28",21477737,5084,495,3914,1170,4589,2.30471208395931,5.44750128935837,0.298926928972918
"United States","Florida","FL",2020-07-12,2020-07-18,7,2020,"29",21477737,5509,698,3884,1625,4811,3.24987683758303,7.56597401299774,0.418383110195675
"United States","Florida","FL",2020-07-19,2020-07-25,7,2020,"30",21477737,5704,882,3841,1863,4822,4.10657789505477,8.67409820690141,0.48502994011976
"United States","Florida","FL",2020-07-26,2020-08-01,7,2020,"31",21477737,5791,1245,3829,1962,4546,5.79670008995827,9.13504062369327,0.512405327761818
"United States","Florida","FL",2020-08-02,2020-08-08,7,2020,"32",21477737,5585,1087,3819,1766,4498,5.06105461669449,8.22246775812554,0.4624247185127
"United States","Florida","FL",2020-08-09,2020-08-15,7,2020,"33",21477737,5510,1236,3810,1700,4274,5.75479623388628,7.91517281359763,0.446194225721785
"United States","Florida","FL",2020-08-16,2020-08-22,7,2020,"34",21477737,5203,929,3802,1401,4274,4.32540914343071,6.52303359520605,0.368490268279853
"United States","Florida","FL",2020-08-23,2020-08-29,7,2020,"35",21477737,5015,831,3819,1196,4184,3.86912271064684,5.56855687356634,0.313170987169416
"United States","Florida","FL",2020-08-30,2020-09-05,7,2020,"36",21477737,4758,706,3825,933,4052,3.28712470964702,4.3440330794627,0.243921568627451
"United States","Florida","FL",2020-09-06,2020-09-12,7,2020,"37",21477737,4513,789,3834,679,3724,3.6735713823109,3.16141314143105,0.177099634846114
"United States","Florida","FL",2020-09-13,2020-09-19,7,2020,"38",21477737,4667,687,3846,821,3980,3.19866101349504,3.82256287056686,0.21346853874155
"United States","Florida","FL",2020-09-20,2020-09-26,7,2020,"39",21477737,4444,735,3872,572,3709,3.42214824587898,2.6632228525752,0.147727272727273
"United States","Florida","FL",2020-09-27,2020-10-03,7,2020,"40",21477737,4346,606,3850,496,3740,2.82152630884716,2.30936806796731,0.128831168831169
"United States","Florida","FL",2020-10-04,2020-10-10,7,2020,"41",21477737,4525,736,3862,663,3789,3.42680422988698,3.08691739730308,0.171672708441222
"United States","Florida","FL",2020-10-11,2020-10-17,7,2020,"42",21477737,4389,553,3843,546,3836,2.57475915642323,2.54216726836724,0.14207650273224
"United States","Florida","FL",2020-10-18,2020-10-24,7,2020,"43",21477737,4335,500,3866,469,3835,2.3279920039993,2.18365649975135,0.121314019658562
"United States","Florida","FL",2020-10-25,2020-10-31,7,2020,"44",21477737,4265,344,3885,380,3921,1.60165849875152,1.76927392303947,0.0978120978120978
"United States","Florida","FL",2020-11-01,2020-11-07,7,2020,"45",21477737,4305,339,3923,382,3966,1.57837857871153,1.77858589105547,0.0973744583227123
"United States","Florida","FL",2020-11-08,2020-11-14,7,2020,"46",21477737,4487,388,3947,540,4099,1.80652179510346,2.51423136431925,0.136812769191791
"United States","Florida","FL",2020-11-15,2020-11-21,7,2020,"47",21477737,4561,442,4008,553,4119,2.05794493153538,2.57475915642323,0.137974051896208
"United States","Florida","FL",2020-11-22,2020-11-28,7,2020,"48",21477737,4634,507,4032,602,4127,2.36058389205529,2.80290237281516,0.149305555555556
"United States","Florida","FL",2020-11-29,2020-12-05,7,2020,"49",21477737,4911,632,4068,843,4279,2.94258189305512,3.92499451874283,0.207227138643068
"United States","Florida","FL",2020-12-06,2020-12-12,7,2020,"50",21477737,5085,716,4121,964,4369,3.333684549727,4.48836858371066,0.233923804901723
"United States","Florida","FL",2020-12-13,2020-12-19,7,2020,"51",21477737,4945,688,4163,782,4257,3.20331699750304,3.64097949425491,0.187845303867403
"United States","Florida","FL",2020-12-20,2020-12-26,7,2020,"52",21477737,5137,661,4189,948,4476,3.07760542928708,4.41387283958268,0.226306994509429
"United States","Florida","FL",2020-12-27,2021-01-02,7,2020,"53",21477737,5709,753,4273,1436,4956,3.50595595802295,6.685993035486,0.33606365551135
"United States","Florida","FL",2021-01-03,2021-01-09,7,2021,"1",21477737,5497,917,4306,1191,4580,4.26953733533472,5.54527695352634,0.276590803529958
"United States","Florida","FL",2021-01-10,2021-01-16,7,2021,"2",21477737,5923,1200,4323,1600,4723,5.58718080959833,7.44957441279777,0.370113347212584
"United States","Florida","FL",2021-01-17,2021-01-23,7,2021,"3",21477737,5664,1160,4420,1244,4504,5.40094144927839,5.79204410595027,0.281447963800905
"United States","Florida","FL",2021-01-24,2021-01-30,7,2021,"4",21477737,5507,1196,4485,1022,4311,5.56855687356634,4.75841565617458,0.227870680044593
"United States","Florida","FL",2021-01-31,2021-02-06,7,2021,"5",21477737,5588,1243,4438,1150,4345,5.78738812194227,5.3543816091984,0.259125732311852
"United States","Florida","FL",2021-02-07,2021-02-13,7,2021,"6",21477737,5478,1085,4444,1034,4393,5.05174264867849,4.81428746427056,0.232673267326733
"United States","Florida","FL",2021-02-14,2021-02-20,7,2021,"7",21477737,5137,1126,4351,786,4011,5.24263799300643,3.65960343028691,0.180648126867387
"United States","Florida","FL",2021-02-21,2021-02-27,7,2021,"8",21477737,4910,926,4319,591,3984,4.31144119140671,2.75168654872718,0.136837230840472
"United States","Florida","FL",2021-02-28,2021-03-06,7,2021,"9",21477737,4836,886,4291,545,3950,4.12520183108677,2.53751128435924,0.127010020974132
"United States","Florida","FL",2021-03-07,2021-03-13,7,2021,"10",21477737,4652,628,4296,356,4024,2.92395795702313,1.6575303068475,0.0828677839851024
"United States","Florida","FL",2021-03-14,2021-03-20,7,2021,"11",21477737,4599,477,4291,308,4122,2.22090437181534,1.43404307446357,0.0717781402936379
"United States","Florida","FL",2021-03-21,2021-03-27,7,2021,"12",21477737,4745,444,4283,462,4301,2.06725689955138,2.15106461169536,0.107868316600514
"United States","Florida","FL",2021-03-28,2021-04-03,7,2021,"13",21477737,4489,497,4250,239,3992,2.31402405197531,1.11278017791167,0.0562352941176472
"United States","Florida","FL",2021-04-04,2021-04-10,7,2021,"14",21477737,4713,342,4199,514,4371,1.59234653073552,2.39317578011128,0.122410097642296
"United States","Florida","FL",2021-04-11,2021-04-17,7,2021,"15",21477737,4657,390,4141,516,4267,1.81583376311946,2.40248774812728,0.124607582709491
"United States","Florida","FL",2021-04-18,2021-04-24,7,2021,"16",21477737,4737,408,4118,619,4329,1.89964147526343,2.88205410095114,0.150315687226809
"United States","Florida","FL",2021-04-25,2021-05-01,7,2021,"17",21477737,4494,427,4054,440,4067,1.98810517141541,2.04863296351939,0.10853478046374
"United States","Florida","FL",2021-05-02,2021-05-08,7,2021,"18",21477737,4615,461,4006,609,4154,2.14640862768736,2.83549426087115,0.152021967049426
"United States","Florida","FL",2021-05-09,2021-05-15,7,2021,"19",21477737,4538,356,3952,586,4182,1.6575303068475,2.72840662868718,0.148279352226721
"United States","Florida","FL",2021-05-16,2021-05-22,7,2021,"20",21477737,4602,407,3934,668,4195,1.89498549125543,3.11019731734307,0.16980172852059
"United States","Florida","FL",2021-05-23,2021-05-29,7,2021,"21",21477737,4528,311,3915,613,4217,1.44801102648757,2.85411819690315,0.156577266922095
"United States","Florida","FL",2021-05-30,2021-06-05,7,2021,"22",21477737,4390,199,3878,512,4191,0.926540817591723,2.38386381209529,0.132026817947396
"United States","Florida","FL",2021-06-06,2021-06-12,7,2021,"23",21477737,4438,292,3874,564,4146,1.35954733033559,2.62597498051122,0.145585957666495
"United States","Florida","FL",2021-06-13,2021-06-19,7,2021,"24",21477737,4401,290,3872,529,4111,1.3502353623196,2.46301554023126,0.136621900826446
"United States","Florida","FL",2021-06-20,2021-06-26,7,2021,"25",21477737,4416,217,3873,543,4199,1.0103485297357,2.52819931634324,0.140201394268009
"United States","Florida","FL",2021-06-27,2021-07-03,7,2021,"26",21477737,4178,213,3857,321,3965,0.991724593703704,1.49457086656755,0.0832253046409126
"United States","Florida","FL",2021-07-04,2021-07-10,7,2021,"27",21477737,3735,172,3845,-110,3563,0.800829249375761,-0.512158240879847,-0.0286085825747724
"United States","Georgia","GA",2019-12-29,2020-01-04,7,2020,"1",10617423,1803,0,1887,-84,1803,0,-0.791152429360684,-0.0445151033386327
"United States","Georgia","GA",2020-01-05,2020-01-11,7,2020,"2",10617423,1807,0,1906,-99,1807,0,-0.932429648889377,-0.0519412381951732
"United States","Georgia","GA",2020-01-12,2020-01-18,7,2020,"3",10617423,1746,0,1920,-174,1746,0,-1.63881574653285,-0.090625
"United States","Georgia","GA",2020-01-19,2020-01-25,7,2020,"4",10617423,1829,0,1912,-83,1829,0,-0.781733948058771,-0.0434100418410042
"United States","Georgia","GA",2020-01-26,2020-02-01,7,2020,"5",10617423,1797,0,1905,-108,1797,0,-1.01719598060659,-0.0566929133858268
"United States","Georgia","GA",2020-02-02,2020-02-08,7,2020,"6",10617423,1781,0,1842,-61,1781,0,-0.574527359416687,-0.0331161780673181
"United States","Georgia","GA",2020-02-09,2020-02-15,7,2020,"7",10617423,1762,0,1802,-40,1762,0,-0.376739252076516,-0.0221975582685905
"United States","Georgia","GA",2020-02-16,2020-02-22,7,2020,"8",10617423,1749,0,1746,3,1749,0,0.0282554439057387,0.00171821305841924
"United States","Georgia","GA",2020-02-23,2020-02-29,7,2020,"9",10617423,1860,0,1750,110,1860,0,1.03603294321042,0.0628571428571429
"United States","Georgia","GA",2020-03-01,2020-03-07,7,2020,"10",10617423,1755,0,1758,-3,1755,0,-0.0282554439057387,-0.00170648464163825
"United States","Georgia","GA",2020-03-08,2020-03-14,7,2020,"11",10617423,1784,1,1757,27,1783,0.0094184813019129,0.254298995151648,0.0153671030165055
"United States","Georgia","GA",2020-03-15,2020-03-21,7,2020,"12",10617423,1775,19,1765,10,1756,0.178951144736345,0.094184813019129,0.0056657223796035
"United States","Georgia","GA",2020-03-22,2020-03-28,7,2020,"13",10617423,1881,58,1755,126,1823,0.546271915510948,1.18672864404103,0.0717948717948718
"United States","Georgia","GA",2020-03-29,2020-04-04,7,2020,"14",10617423,2033,129,1729,304,1904,1.21498408794676,2.86321831578152,0.175824175824176
"United States","Georgia","GA",2020-04-05,2020-04-11,7,2020,"15",10617423,2042,223,1727,315,1819,2.10032133032658,2.96682161010256,0.182397220613781
"United States","Georgia","GA",2020-04-12,2020-04-18,7,2020,"16",10617423,2032,243,1702,330,1789,2.28869095636484,3.10809882963126,0.193889541715629
"United States","Georgia","GA",2020-04-19,2020-04-25,7,2020,"17",10617423,2040,229,1682,358,1811,2.15683221813805,3.37181630608482,0.212841854934602
"United States","Georgia","GA",2020-04-26,2020-05-02,7,2020,"18",10617423,1975,263,1664,311,1712,2.47706058240309,2.92914768489491,0.186899038461539
"United States","Georgia","GA",2020-05-03,2020-05-09,7,2020,"19",10617423,1987,225,1647,340,1762,2.1191582929304,3.20228364265039,0.206435944140862
"United States","Georgia","GA",2020-05-10,2020-05-16,7,2020,"20",10617423,1961,194,1629,332,1767,1.8271853725711,3.12693579223508,0.203806015960712
"United States","Georgia","GA",2020-05-17,2020-05-23,7,2020,"21",10617423,1911,234,1613,298,1677,2.20392462464762,2.80670742797005,0.184748915065096
"United States","Georgia","GA",2020-05-24,2020-05-30,7,2020,"22",10617423,1785,180,1596,189,1605,1.69532663434432,1.78009296606154,0.118421052631579
"United States","Georgia","GA",2020-05-31,2020-06-06,7,2020,"23",10617423,1782,173,1591,191,1609,1.62939726523093,1.79892992866536,0.12005028284098
"United States","Georgia","GA",2020-06-07,2020-06-13,7,2020,"24",10617423,1746,269,1594,152,1477,2.53357147021457,1.43160915789076,0.0953575909661231
"United States","Georgia","GA",2020-06-14,2020-06-20,7,2020,"25",10617423,1780,192,1588,192,1588,1.80834840996728,1.80834840996728,0.120906801007557
"United States","Georgia","GA",2020-06-21,2020-06-27,7,2020,"26",10617423,1823,145,1583,240,1678,1.36567978877737,2.2604355124591,0.151610865445357
"United States","Georgia","GA",2020-06-28,2020-07-04,7,2020,"27",10617423,1880,83,1575,305,1797,0.781733948058771,2.87263679708344,0.193650793650794
"United States","Georgia","GA",2020-07-05,2020-07-11,7,2020,"28",10617423,1983,137,1579,404,1846,1.29033193836207,3.80506644597281,0.255858138062065
"United States","Georgia","GA",2020-07-12,2020-07-18,7,2020,"29",10617423,2177,171,1574,603,2006,1.61056030262711,5.67934422505348,0.383100381194409
"United States","Georgia","GA",2020-07-19,2020-07-25,7,2020,"30",10617423,2177,327,1585,592,1850,3.07984338572552,5.57574093073244,0.373501577287066
"United States","Georgia","GA",2020-07-26,2020-08-01,7,2020,"31",10617423,2193,330,1588,605,1863,3.10809882963126,5.69818118765731,0.380982367758187
"United States","Georgia","GA",2020-08-02,2020-08-08,7,2020,"32",10617423,2192,361,1598,594,1831,3.40007174999056,5.59457789333626,0.37171464330413
"United States","Georgia","GA",2020-08-09,2020-08-15,7,2020,"33",10617423,2245,483,1596,649,1762,4.54912646882393,6.11259436494147,0.406641604010025
"United States","Georgia","GA",2020-08-16,2020-08-22,7,2020,"34",10617423,2247,423,1587,660,1824,3.98401759070916,6.21619765926252,0.415879017013232
"United States","Georgia","GA",2020-08-23,2020-08-29,7,2020,"35",10617423,2132,484,1590,542,1648,4.55854495012585,5.10481686563679,0.340880503144654
"United States","Georgia","GA",2020-08-30,2020-09-05,7,2020,"36",10617423,2044,401,1591,453,1643,3.77681100206707,4.26657202976654,0.284726587052168
"United States","Georgia","GA",2020-09-06,2020-09-12,7,2020,"37",10617423,2073,310,1574,499,1763,2.919729203593,4.69982216965454,0.31702668360864
"United States","Georgia","GA",2020-09-13,2020-09-19,7,2020,"38",10617423,1928,312,1574,354,1616,2.93856616619683,3.33414238087717,0.224904701397713
"United States","Georgia","GA",2020-09-20,2020-09-26,7,2020,"39",10617423,1997,315,1580,417,1682,2.96682161010256,3.92750670289768,0.263924050632911
"United States","Georgia","GA",2020-09-27,2020-10-03,7,2020,"40",10617423,1926,220,1586,340,1706,2.07206588642084,3.20228364265039,0.21437578814628
"United States","Georgia","GA",2020-10-04,2020-10-10,7,2020,"41",10617423,1886,259,1587,299,1627,2.43938665719544,2.81612590927196,0.188405797101449
"United States","Georgia","GA",2020-10-11,2020-10-17,7,2020,"42",10617423,1923,214,1605,318,1709,2.01555499860936,2.9950770540083,0.198130841121495
"United States","Georgia","GA",2020-10-18,2020-10-24,7,2020,"43",10617423,1960,201,1607,353,1759,1.89311474168449,3.32472389957525,0.219663970130678
"United States","Georgia","GA",2020-10-25,2020-10-31,7,2020,"44",10617423,1944,163,1628,316,1781,1.5352124522118,2.97624009140448,0.194103194103194
"United States","Georgia","GA",2020-11-01,2020-11-07,7,2020,"45",10617423,2020,219,1643,377,1801,2.06264740511893,3.55076745082116,0.22945830797322
"United States","Georgia","GA",2020-11-08,2020-11-14,7,2020,"46",10617423,2050,257,1650,400,1793,2.42054969459162,3.76739252076516,0.242424242424242
"United States","Georgia","GA",2020-11-15,2020-11-21,7,2020,"47",10617423,1978,166,1676,302,1812,1.56346789611754,2.8443813531777,0.18019093078759
"United States","Georgia","GA",2020-11-22,2020-11-28,7,2020,"48",10617423,2070,158,1711,359,1912,1.48812004570224,3.38123478738673,0.209818819403857
"United States","Georgia","GA",2020-11-29,2020-12-05,7,2020,"49",10617423,2171,196,1736,435,1975,1.84602233517493,4.09703936633211,0.250576036866359
"United States","Georgia","GA",2020-12-06,2020-12-12,7,2020,"50",10617423,2241,236,1750,491,2005,2.22276158725145,4.62447431923924,0.280571428571428
"United States","Georgia","GA",2020-12-13,2020-12-19,7,2020,"51",10617423,2422,231,1767,655,2191,2.17566918074188,6.16910525275295,0.370684776457272
"United States","Georgia","GA",2020-12-20,2020-12-26,7,2020,"52",10617423,2379,274,1794,585,2105,2.58066387672414,5.50981156161905,0.326086956521739
"United States","Georgia","GA",2020-12-27,2021-01-02,7,2020,"53",10617423,2721,183,1819,902,2538,1.72358207825006,8.49547013432544,0.495876855415063
"United States","Georgia","GA",2021-01-03,2021-01-09,7,2021,"1",10617423,2856,389,1834,1022,2467,3.66378922644412,9.62568789055499,0.557251908396946
"United States","Georgia","GA",2021-01-10,2021-01-16,7,2021,"2",10617423,3081,749,1848,1233,2332,7.05444249513276,11.6129874452586,0.667207792207792
"United States","Georgia","GA",2021-01-17,2021-01-23,7,2021,"3",10617423,2937,769,1852,1085,2168,7.24281212117102,10.2190522125755,0.58585313174946
"United States","Georgia","GA",2021-01-24,2021-01-30,7,2021,"4",10617423,2775,770,1828,947,2005,7.25223060247294,8.91930179291152,0.518052516411379
"United States","Georgia","GA",2021-01-31,2021-02-06,7,2021,"5",10617423,2717,756,1807,910,1961,7.12037186424615,8.57081798474074,0.503597122302158
"United States","Georgia","GA",2021-02-07,2021-02-13,7,2021,"6",10617423,2382,638,1775,607,1744,6.00899107062043,5.71701815026113,0.341971830985915
"United States","Georgia","GA",2021-02-14,2021-02-20,7,2021,"7",10617423,2281,668,1752,529,1613,6.29154550967782,4.98237660871193,0.301940639269406
"United States","Georgia","GA",2021-02-21,2021-02-27,7,2021,"8",10617423,2105,438,1723,382,1667,4.12529481023785,3.59785985733073,0.221706326175276
"United States","Georgia","GA",2021-02-28,2021-03-06,7,2021,"9",10617423,1941,536,1726,215,1405,5.04830597782532,2.02497347991127,0.124565469293163
"United States","Georgia","GA",2021-03-07,2021-03-13,7,2021,"10",10617423,1990,285,1717,273,1705,2.68426717104518,2.57124539542222,0.158998252766453
"United States","Georgia","GA",2021-03-14,2021-03-20,7,2021,"11",10617423,1919,275,1730,189,1644,2.59008235802605,1.78009296606154,0.109248554913295
"United States","Georgia","GA",2021-03-21,2021-03-27,7,2021,"12",10617423,1885,336,1723,162,1549,3.16460971744274,1.52579397090989,0.0940220545560069
"United States","Georgia","GA",2021-03-28,2021-04-03,7,2021,"13",10617423,1747,2710,1718,29,-963,25.524084328184,0.273135957755474,0.0168800931315483
"United States","Georgia","GA",2021-04-04,2021-04-10,7,2021,"14",10617423,1932,278,1717,215,1654,2.61833780193179,2.02497347991127,0.125218404193361
"United States","Georgia","GA",2021-04-11,2021-04-17,7,2021,"15",10617423,1862,269,1703,159,1593,2.53357147021457,1.49753852700415,0.0933646506165591
"United States","Georgia","GA",2021-04-18,2021-04-24,7,2021,"16",10617423,1875,216,1709,166,1659,2.03439196121319,1.56346789611754,0.0971328262141604
"United States","Georgia","GA",2021-04-25,2021-05-01,7,2021,"17",10617423,1803,239,1691,112,1564,2.25101703115718,1.05486990581425,0.0662329982259018
"United States","Georgia","GA",2021-05-02,2021-05-08,7,2021,"18",10617423,1798,156,1683,115,1642,1.46928308309841,1.08312534971998,0.0683303624480096
"United States","Georgia","GA",2021-05-09,2021-05-15,7,2021,"19",10617423,1770,137,1658,112,1633,1.29033193836207,1.05486990581425,0.0675512665862485
"United States","Georgia","GA",2021-05-16,2021-05-22,7,2021,"20",10617423,1834,156,1638,196,1678,1.46928308309841,1.84602233517493,0.11965811965812
"United States","Georgia","GA",2021-05-23,2021-05-29,7,2021,"21",10617423,1823,176,1631,192,1647,1.65765270913667,1.80834840996728,0.117719190680564
"United States","Georgia","GA",2021-05-30,2021-06-05,7,2021,"22",10617423,1725,149,1621,104,1576,1.40335371398502,0.979522055398942,0.0641579272054287
"United States","Georgia","GA",2021-06-06,2021-06-12,7,2021,"23",10617423,1696,172,1615,81,1524,1.61997878392902,0.762896985454945,0.05015479876161
"United States","Georgia","GA",2021-06-13,2021-06-19,7,2021,"24",10617423,1624,161,1612,12,1463,1.51637548960798,0.113021775622955,0.00744416873449127
"United States","Georgia","GA",2021-06-20,2021-06-26,7,2021,"25",10617423,1575,74,1597,-22,1501,0.696967616341555,-0.207206588642084,-0.0137758296806513
"United States","Georgia","GA",2021-06-27,2021-07-03,7,2021,"26",10617423,1372,50,1600,-228,1322,0.470924065095645,-2.14741373683614,-0.1425
"United States","Georgia","GA",2021-07-04,2021-07-10,7,2021,"27",10617423,1088,43,1595,-507,1045,0.404994695982255,-4.77517002006984,-0.317868338557994
"United States","Hawaii","HI",2019-12-29,2020-01-04,7,2020,"1",1415872,242,0,263,-21,242,0,-1.4831849206708,-0.0798479087452472
"United States","Hawaii","HI",2020-01-05,2020-01-11,7,2020,"2",1415872,242,0,262,-20,242,0,-1.41255706730552,-0.0763358778625954
"United States","Hawaii","HI",2020-01-12,2020-01-18,7,2020,"3",1415872,215,0,262,-47,215,0,-3.31950910816797,-0.179389312977099
"United States","Hawaii","HI",2020-01-19,2020-01-25,7,2020,"4",1415872,242,0,254,-12,242,0,-0.847534240383311,-0.047244094488189
"United States","Hawaii","HI",2020-01-26,2020-02-01,7,2020,"5",1415872,242,0,249,-7,242,0,-0.494394973556932,-0.0281124497991968
"United States","Hawaii","HI",2020-02-02,2020-02-08,7,2020,"6",1415872,236,0,249,-13,236,0,-0.918162093748587,-0.0522088353413654
"United States","Hawaii","HI",2020-02-09,2020-02-15,7,2020,"7",1415872,281,0,248,33,281,0,2.33071916105411,0.133064516129032
"United States","Hawaii","HI",2020-02-16,2020-02-22,7,2020,"8",1415872,250,0,250,0,250,0,0,0
"United States","Hawaii","HI",2020-02-23,2020-02-29,7,2020,"9",1415872,238,0,251,-13,238,0,-0.918162093748587,-0.0517928286852589
"United States","Hawaii","HI",2020-03-01,2020-03-07,7,2020,"10",1415872,239,0,248,-9,239,0,-0.635650680287484,-0.0362903225806451
"United States","Hawaii","HI",2020-03-08,2020-03-14,7,2020,"11",1415872,243,0,247,-4,243,0,-0.282511413461104,-0.0161943319838057
"United States","Hawaii","HI",2020-03-15,2020-03-21,7,2020,"12",1415872,212,0,247,-35,212,0,-2.47197486778466,-0.1417004048583
"United States","Hawaii","HI",2020-03-22,2020-03-28,7,2020,"13",1415872,235,0,247,-12,235,0,-0.847534240383311,-0.048582995951417
"United States","Hawaii","HI",2020-03-29,2020-04-04,7,2020,"14",1415872,235,3,237,-2,232,0.211883560095828,-0.141255706730552,-0.00843881856540085
"United States","Hawaii","HI",2020-04-05,2020-04-11,7,2020,"15",1415872,221,5,234,-13,216,0.35313926682638,-0.918162093748587,-0.0555555555555556
"United States","Hawaii","HI",2020-04-12,2020-04-18,7,2020,"16",1415872,211,1,231,-20,210,0.070627853365276,-1.41255706730552,-0.0865800865800865
"United States","Hawaii","HI",2020-04-19,2020-04-25,7,2020,"17",1415872,200,0,230,-30,200,0,-2.11883560095828,-0.130434782608696
"United States","Hawaii","HI",2020-04-26,2020-05-02,7,2020,"18",1415872,223,7,225,-2,216,0.494394973556932,-0.141255706730552,-0.00888888888888884
"United States","Hawaii","HI",2020-05-03,2020-05-09,7,2020,"19",1415872,210,1,227,-17,209,0.070627853365276,-1.20067350720969,-0.0748898678414097
"United States","Hawaii","HI",2020-05-10,2020-05-16,7,2020,"20",1415872,230,0,225,5,230,0,0.35313926682638,0.0222222222222221
"United States","Hawaii","HI",2020-05-17,2020-05-23,7,2020,"21",1415872,210,0,221,-11,210,0,-0.776906387018036,-0.0497737556561086
"United States","Hawaii","HI",2020-05-24,2020-05-30,7,2020,"22",1415872,200,0,223,-23,200,0,-1.62444062740135,-0.103139013452915
"United States","Hawaii","HI",2020-05-31,2020-06-06,7,2020,"23",1415872,217,0,225,-8,217,0,-0.565022826922208,-0.0355555555555556
"United States","Hawaii","HI",2020-06-07,2020-06-13,7,2020,"24",1415872,203,0,225,-22,203,0,-1.55381277403607,-0.0977777777777777
"United States","Hawaii","HI",2020-06-14,2020-06-20,7,2020,"25",1415872,246,0,226,20,246,0,1.41255706730552,0.0884955752212389
"United States","Hawaii","HI",2020-06-21,2020-06-27,7,2020,"26",1415872,236,1,225,11,235,0.070627853365276,0.776906387018036,0.048888888888889
"United States","Hawaii","HI",2020-06-28,2020-07-04,7,2020,"27",1415872,207,1,223,-16,206,0.070627853365276,-1.13004565384442,-0.0717488789237668
"United States","Hawaii","HI",2020-07-05,2020-07-11,7,2020,"28",1415872,239,0,218,21,239,0,1.4831849206708,0.0963302752293578
"United States","Hawaii","HI",2020-07-12,2020-07-18,7,2020,"29",1415872,227,5,214,13,222,0.35313926682638,0.918162093748587,0.0607476635514019
"United States","Hawaii","HI",2020-07-19,2020-07-25,7,2020,"30",1415872,219,2,210,9,217,0.141255706730552,0.635650680287484,0.0428571428571429
"United States","Hawaii","HI",2020-07-26,2020-08-01,7,2020,"31",1415872,217,0,211,6,217,0,0.423767120191656,0.028436018957346
"United States","Hawaii","HI",2020-08-02,2020-08-08,7,2020,"32",1415872,231,5,208,23,226,0.35313926682638,1.62444062740135,0.110576923076923
"United States","Hawaii","HI",2020-08-09,2020-08-15,7,2020,"33",1415872,223,9,211,12,214,0.635650680287484,0.847534240383311,0.0568720379146919
"United States","Hawaii","HI",2020-08-16,2020-08-22,7,2020,"34",1415872,242,7,213,29,235,0.494394973556932,2.048207747593,0.136150234741784
"United States","Hawaii","HI",2020-08-23,2020-08-29,7,2020,"35",1415872,255,15,215,40,240,1.05941780047914,2.82511413461104,0.186046511627907
"United States","Hawaii","HI",2020-08-30,2020-09-05,7,2020,"36",1415872,235,22,217,18,213,1.55381277403607,1.27130136057497,0.0829493087557605
"United States","Hawaii","HI",2020-09-06,2020-09-12,7,2020,"37",1415872,274,13,218,56,261,0.918162093748587,3.95515978845545,0.256880733944954
"United States","Hawaii","HI",2020-09-13,2020-09-19,7,2020,"38",1415872,242,23,215,27,219,1.62444062740135,1.90695204086245,0.125581395348837
"United States","Hawaii","HI",2020-09-20,2020-09-26,7,2020,"39",1415872,242,11,214,28,231,0.776906387018036,1.97757989422773,0.130841121495327
"United States","Hawaii","HI",2020-09-27,2020-10-03,7,2020,"40",1415872,214,22,213,1,192,1.55381277403607,0.070627853365276,0.00469483568075124
"United States","Hawaii","HI",2020-10-04,2020-10-10,7,2020,"41",1415872,231,15,213,18,216,1.05941780047914,1.27130136057497,0.0845070422535212
"United States","Hawaii","HI",2020-10-11,2020-10-17,7,2020,"42",1415872,237,18,211,26,219,1.27130136057497,1.83632418749717,0.123222748815166
"United States","Hawaii","HI",2020-10-18,2020-10-24,7,2020,"43",1415872,237,26,215,22,211,1.83632418749717,1.55381277403607,0.102325581395349
"United States","Hawaii","HI",2020-10-25,2020-10-31,7,2020,"44",1415872,238,7,219,19,231,0.494394973556932,1.34192921394024,0.08675799086758
"United States","Hawaii","HI",2020-11-01,2020-11-07,7,2020,"45",1415872,236,1,219,17,235,0.070627853365276,1.20067350720969,0.0776255707762556
"United States","Hawaii","HI",2020-11-08,2020-11-14,7,2020,"46",1415872,249,2,219,30,247,0.141255706730552,2.11883560095828,0.136986301369863
"United States","Hawaii","HI",2020-11-15,2020-11-21,7,2020,"47",1415872,224,9,228,-4,215,0.635650680287484,-0.282511413461104,-0.0175438596491229
"United States","Hawaii","HI",2020-11-22,2020-11-28,7,2020,"48",1415872,216,9,228,-12,207,0.635650680287484,-0.847534240383311,-0.0526315789473685
"United States","Hawaii","HI",2020-11-29,2020-12-05,7,2020,"49",1415872,237,21,230,7,216,1.4831849206708,0.494394973556932,0.0304347826086957
"United States","Hawaii","HI",2020-12-06,2020-12-12,7,2020,"50",1415872,212,8,238,-26,204,0.565022826922208,-1.83632418749717,-0.109243697478992
"United States","Hawaii","HI",2020-12-13,2020-12-19,7,2020,"51",1415872,249,0,246,3,249,0,0.211883560095828,0.0121951219512195
"United States","Hawaii","HI",2020-12-20,2020-12-26,7,2020,"52",1415872,198,0,242,-44,198,0,-3.10762554807214,-0.181818181818182
"United States","Hawaii","HI",2020-12-27,2021-01-02,7,2020,"53",1415872,225,0,249,-24,225,0,-1.69506848076662,-0.0963855421686747
"United States","Hawaii","HI",2021-01-03,2021-01-09,7,2021,"1",1415872,215,38,253,-38,177,2.68385842788049,-2.68385842788049,-0.150197628458498
"United States","Hawaii","HI",2021-01-10,2021-01-16,7,2021,"2",1415872,246,13,250,-4,233,0.918162093748587,-0.282511413461104,-0.016
"United States","Hawaii","HI",2021-01-17,2021-01-23,7,2021,"3",1415872,205,8,248,-43,197,0.565022826922208,-3.03699769470687,-0.173387096774194
"United States","Hawaii","HI",2021-01-24,2021-01-30,7,2021,"4",1415872,229,73,245,-16,156,5.15583329566515,-1.13004565384442,-0.0653061224489796
"United States","Hawaii","HI",2021-01-31,2021-02-06,7,2021,"5",1415872,240,15,244,-4,225,1.05941780047914,-0.282511413461104,-0.0163934426229508
"United States","Hawaii","HI",2021-02-07,2021-02-13,7,2021,"6",1415872,268,9,244,24,259,0.635650680287484,1.69506848076662,0.098360655737705
"United States","Hawaii","HI",2021-02-14,2021-02-20,7,2021,"7",1415872,254,5,246,8,249,0.35313926682638,0.565022826922208,0.032520325203252
"United States","Hawaii","HI",2021-02-21,2021-02-27,7,2021,"8",1415872,265,9,250,15,256,0.635650680287484,1.05941780047914,0.0600000000000001
"United States","Hawaii","HI",2021-02-28,2021-03-06,7,2021,"9",1415872,231,5,254,-23,226,0.35313926682638,-1.62444062740135,-0.0905511811023622
"United States","Hawaii","HI",2021-03-07,2021-03-13,7,2021,"10",1415872,256,5,249,7,251,0.35313926682638,0.494394973556932,0.0281124497991967
"United States","Hawaii","HI",2021-03-14,2021-03-20,7,2021,"11",1415872,236,4,252,-16,232,0.282511413461104,-1.13004565384442,-0.0634920634920635
"United States","Hawaii","HI",2021-03-21,2021-03-27,7,2021,"12",1415872,245,9,246,-1,236,0.635650680287484,-0.070627853365276,-0.00406504065040647
"United States","Hawaii","HI",2021-03-28,2021-04-03,7,2021,"13",1415872,251,5,240,11,246,0.35313926682638,0.776906387018036,0.0458333333333334
"United States","Hawaii","HI",2021-04-04,2021-04-10,7,2021,"14",1415872,252,4,233,19,248,0.282511413461104,1.34192921394024,0.0815450643776825
"United States","Hawaii","HI",2021-04-11,2021-04-17,7,2021,"15",1415872,220,3,233,-13,217,0.211883560095828,-0.918162093748587,-0.055793991416309
"United States","Hawaii","HI",2021-04-18,2021-04-24,7,2021,"16",1415872,256,4,228,28,252,0.282511413461104,1.97757989422773,0.12280701754386
"United States","Hawaii","HI",2021-04-25,2021-05-01,7,2021,"17",1415872,236,5,227,9,231,0.35313926682638,0.635650680287484,0.0396475770925111
"United States","Hawaii","HI",2021-05-02,2021-05-08,7,2021,"18",1415872,240,4,227,13,236,0.282511413461104,0.918162093748587,0.0572687224669604
"United States","Hawaii","HI",2021-05-09,2021-05-15,7,2021,"19",1415872,234,3,229,5,231,0.211883560095828,0.35313926682638,0.0218340611353711
"United States","Hawaii","HI",2021-05-16,2021-05-22,7,2021,"20",1415872,256,4,228,28,252,0.282511413461104,1.97757989422773,0.12280701754386
"United States","Hawaii","HI",2021-05-23,2021-05-29,7,2021,"21",1415872,213,5,225,-12,208,0.35313926682638,-0.847534240383311,-0.0533333333333333
"United States","Hawaii","HI",2021-05-30,2021-06-05,7,2021,"22",1415872,211,3,226,-15,208,0.211883560095828,-1.05941780047914,-0.0663716814159292
"United States","Hawaii","HI",2021-06-06,2021-06-12,7,2021,"23",1415872,224,3,227,-3,221,0.211883560095828,-0.211883560095828,-0.013215859030837
"United States","Hawaii","HI",2021-06-13,2021-06-19,7,2021,"24",1415872,230,5,226,4,225,0.35313926682638,0.282511413461104,0.0176991150442478
"United States","Hawaii","HI",2021-06-20,2021-06-26,7,2021,"25",1415872,220,4,228,-8,216,0.282511413461104,-0.565022826922208,-0.0350877192982456
"United States","Hawaii","HI",2021-06-27,2021-07-03,7,2021,"26",1415872,191,4,228,-37,187,0.282511413461104,-2.61323057451521,-0.162280701754386
"United States","Hawaii","HI",2021-07-04,2021-07-10,7,2021,"27",1415872,205,1,222,-17,204,0.070627853365276,-1.20067350720969,-0.0765765765765766
"United States","Idaho","ID",2019-12-29,2020-01-04,7,2020,"1",1787065,278,0,314,-36,278,0,-2.01447625016438,-0.114649681528662
"United States","Idaho","ID",2020-01-05,2020-01-11,7,2020,"2",1787065,292,0,311,-19,292,0,-1.06319579869787,-0.0610932475884244
"United States","Idaho","ID",2020-01-12,2020-01-18,7,2020,"3",1787065,293,0,313,-20,293,0,-1.11915347231354,-0.0638977635782748
"United States","Idaho","ID",2020-01-19,2020-01-25,7,2020,"4",1787065,275,0,309,-34,275,0,-1.90256090293302,-0.110032362459547
"United States","Idaho","ID",2020-01-26,2020-02-01,7,2020,"5",1787065,249,0,306,-57,249,0,-3.18958739609359,-0.186274509803922
"United States","Idaho","ID",2020-02-02,2020-02-08,7,2020,"6",1787065,292,0,302,-10,292,0,-0.559576736156771,-0.0331125827814569
"United States","Idaho","ID",2020-02-09,2020-02-15,7,2020,"7",1787065,279,0,302,-23,279,0,-1.28702649316057,-0.0761589403973509
"United States","Idaho","ID",2020-02-16,2020-02-22,7,2020,"8",1787065,318,0,300,18,318,0,1.00723812508219,0.0600000000000001
"United States","Idaho","ID",2020-02-23,2020-02-29,7,2020,"9",1787065,290,0,295,-5,290,0,-0.279788368078385,-0.0169491525423728
"United States","Idaho","ID",2020-03-01,2020-03-07,7,2020,"10",1787065,278,0,299,-21,278,0,-1.17511114592922,-0.0702341137123745
"United States","Idaho","ID",2020-03-08,2020-03-14,7,2020,"11",1787065,282,0,301,-19,282,0,-1.06319579869787,-0.0631229235880398
"United States","Idaho","ID",2020-03-15,2020-03-21,7,2020,"12",1787065,308,0,298,10,308,0,0.559576736156771,0.0335570469798658
"United States","Idaho","ID",2020-03-22,2020-03-28,7,2020,"13",1787065,332,5,297,35,327,0.279788368078385,1.9585185765487,0.117845117845118
"United States","Idaho","ID",2020-03-29,2020-04-04,7,2020,"14",1787065,271,5,296,-25,266,0.279788368078385,-1.39894184039193,-0.0844594594594594
"United States","Idaho","ID",2020-04-05,2020-04-11,7,2020,"15",1787065,306,17,292,14,289,0.951280451466511,0.783407430619479,0.047945205479452
"United States","Idaho","ID",2020-04-12,2020-04-18,7,2020,"16",1787065,283,17,291,-8,266,0.951280451466511,-0.447661388925417,-0.0274914089347079
"United States","Idaho","ID",2020-04-19,2020-04-25,7,2020,"17",1787065,262,12,291,-29,250,0.671492083388125,-1.62277253485464,-0.0996563573883161
"United States","Idaho","ID",2020-04-26,2020-05-02,7,2020,"18",1787065,252,7,284,-32,245,0.39170371530974,-1.79064555570167,-0.112676056338028
"United States","Idaho","ID",2020-05-03,2020-05-09,7,2020,"19",1787065,304,4,281,23,300,0.223830694462708,1.28702649316057,0.0818505338078293
"United States","Idaho","ID",2020-05-10,2020-05-16,7,2020,"20",1787065,269,6,285,-16,263,0.335746041694063,-0.895322777850834,-0.0561403508771929
"United States","Idaho","ID",2020-05-17,2020-05-23,7,2020,"21",1787065,262,5,285,-23,257,0.279788368078385,-1.28702649316057,-0.0807017543859649
"United States","Idaho","ID",2020-05-24,2020-05-30,7,2020,"22",1787065,279,4,281,-2,275,0.223830694462708,-0.111915347231354,-0.00711743772241991
"United States","Idaho","ID",2020-05-31,2020-06-06,7,2020,"23",1787065,294,1,286,8,293,0.0559576736156771,0.447661388925417,0.0279720279720279
"United States","Idaho","ID",2020-06-07,2020-06-13,7,2020,"24",1787065,286,3,282,4,283,0.167873020847031,0.223830694462708,0.0141843971631206
"United States","Idaho","ID",2020-06-14,2020-06-20,7,2020,"25",1787065,282,3,284,-2,279,0.167873020847031,-0.111915347231354,-0.00704225352112675
"United States","Idaho","ID",2020-06-21,2020-06-27,7,2020,"26",1787065,296,2,282,14,294,0.111915347231354,0.783407430619479,0.0496453900709219
"United States","Idaho","ID",2020-06-28,2020-07-04,7,2020,"27",1787065,281,1,280,1,280,0.0559576736156771,0.0559576736156771,0.00357142857142856
"United States","Idaho","ID",2020-07-05,2020-07-11,7,2020,"28",1787065,287,10,278,9,277,0.559576736156771,0.503619062541094,0.0323741007194245
"United States","Idaho","ID",2020-07-12,2020-07-18,7,2020,"29",1787065,312,17,274,38,295,0.951280451466511,2.12639159739573,0.138686131386861
"United States","Idaho","ID",2020-07-19,2020-07-25,7,2020,"30",1787065,328,27,275,53,301,1.51085718762328,2.96575670163089,0.192727272727273
"United States","Idaho","ID",2020-07-26,2020-08-01,7,2020,"31",1787065,327,50,272,55,277,2.79788368078386,3.07767204886224,0.202205882352941
"United States","Idaho","ID",2020-08-02,2020-08-08,7,2020,"32",1787065,312,39,271,41,273,2.18234927101141,2.29426461824276,0.151291512915129
"United States","Idaho","ID",2020-08-09,2020-08-15,7,2020,"33",1787065,319,34,267,52,285,1.90256090293302,2.90979902801521,0.194756554307116
"United States","Idaho","ID",2020-08-16,2020-08-22,7,2020,"34",1787065,360,37,266,94,323,2.07043392378005,5.26002131987365,0.353383458646616
"United States","Idaho","ID",2020-08-23,2020-08-29,7,2020,"35",1787065,327,52,263,64,275,2.90979902801521,3.58129111140333,0.243346007604563
"United States","Idaho","ID",2020-08-30,2020-09-05,7,2020,"36",1787065,352,26,264,88,326,1.4548995140076,4.92427527817958,0.333333333333333
"United States","Idaho","ID",2020-09-06,2020-09-12,7,2020,"37",1787065,321,31,269,52,290,1.73468788208599,2.90979902801521,0.193308550185874
"United States","Idaho","ID",2020-09-13,2020-09-19,7,2020,"38",1787065,320,26,271,49,294,1.4548995140076,2.74192600716818,0.180811808118081
"United States","Idaho","ID",2020-09-20,2020-09-26,7,2020,"39",1787065,292,19,270,22,273,1.06319579869787,1.2310688195449,0.0814814814814815
"United States","Idaho","ID",2020-09-27,2020-10-03,7,2020,"40",1787065,328,20,274,54,308,1.11915347231354,3.02171437524656,0.197080291970803
"United States","Idaho","ID",2020-10-04,2020-10-10,7,2020,"41",1787065,300,27,274,26,273,1.51085718762328,1.4548995140076,0.0948905109489051
"United States","Idaho","ID",2020-10-11,2020-10-17,7,2020,"42",1787065,326,22,269,57,304,1.2310688195449,3.18958739609359,0.211895910780669
"United States","Idaho","ID",2020-10-18,2020-10-24,7,2020,"43",1787065,341,42,270,71,299,2.35022229185844,3.97299482671307,0.262962962962963
"United States","Idaho","ID",2020-10-25,2020-10-31,7,2020,"44",1787065,351,57,273,78,294,3.18958739609359,4.36469854202281,0.285714285714286
"United States","Idaho","ID",2020-11-01,2020-11-07,7,2020,"45",1787065,365,54,270,95,311,3.02171437524656,5.31597899348932,0.351851851851852
"United States","Idaho","ID",2020-11-08,2020-11-14,7,2020,"46",1787065,410,68,267,143,342,3.80512180586604,8.00194732704183,0.535580524344569
"United States","Idaho","ID",2020-11-15,2020-11-21,7,2020,"47",1787065,391,95,267,124,296,5.31597899348932,6.93875152834396,0.464419475655431
"United States","Idaho","ID",2020-11-22,2020-11-28,7,2020,"48",1787065,424,68,267,157,356,3.80512180586604,8.78535475766131,0.588014981273408
"United States","Idaho","ID",2020-11-29,2020-12-05,7,2020,"49",1787065,397,119,270,127,278,6.65896316026557,7.10662454919099,0.47037037037037
"United States","Idaho","ID",2020-12-06,2020-12-12,7,2020,"50",1787065,373,137,277,96,236,7.66620128534776,5.371936667105,0.346570397111913
"United States","Idaho","ID",2020-12-13,2020-12-19,7,2020,"51",1787065,394,106,281,113,288,5.93151340326177,6.32321711857151,0.402135231316726
"United States","Idaho","ID",2020-12-20,2020-12-26,7,2020,"52",1787065,390,38,293,97,352,2.12639159739573,5.42789434072068,0.331058020477816
"United States","Idaho","ID",2020-12-27,2021-01-02,7,2020,"53",1787065,349,135,295,54,214,7.55428593811641,3.02171437524656,0.183050847457627
"United States","Idaho","ID",2021-01-03,2021-01-09,7,2021,"1",1787065,389,80,299,90,309,4.47661388925417,5.03619062541094,0.301003344481605
"United States","Idaho","ID",2021-01-10,2021-01-16,7,2021,"2",1787065,340,77,297,43,263,4.30874086840714,2.40617996547412,0.144781144781145
"United States","Idaho","ID",2021-01-17,2021-01-23,7,2021,"3",1787065,339,63,299,40,276,3.52533343778766,2.23830694462708,0.133779264214047
"United States","Idaho","ID",2021-01-24,2021-01-30,7,2021,"4",1787065,287,57,296,-9,230,3.18958739609359,-0.503619062541094,-0.0304054054054054
"United States","Idaho","ID",2021-01-31,2021-02-06,7,2021,"5",1787065,330,42,300,30,288,2.35022229185844,1.67873020847031,0.1
"United States","Idaho","ID",2021-02-07,2021-02-13,7,2021,"6",1787065,308,37,305,3,271,2.07043392378005,0.167873020847031,0.00983606557377059
"United States","Idaho","ID",2021-02-14,2021-02-20,7,2021,"7",1787065,301,22,308,-7,279,1.2310688195449,-0.39170371530974,-0.0227272727272727
"United States","Idaho","ID",2021-02-21,2021-02-27,7,2021,"8",1787065,305,34,310,-5,271,1.90256090293302,-0.279788368078385,-0.0161290322580645
"United States","Idaho","ID",2021-02-28,2021-03-06,7,2021,"9",1787065,310,17,301,9,293,0.951280451466511,0.503619062541094,0.0299003322259137
"United States","Idaho","ID",2021-03-07,2021-03-13,7,2021,"10",1787065,311,33,299,12,278,1.84660322931734,0.671492083388125,0.040133779264214
"United States","Idaho","ID",2021-03-14,2021-03-20,7,2021,"11",1787065,295,31,295,0,264,1.73468788208599,0,0
"United States","Idaho","ID",2021-03-21,2021-03-27,7,2021,"12",1787065,303,15,295,8,288,0.839365104235157,0.447661388925417,0.0271186440677966
"United States","Idaho","ID",2021-03-28,2021-04-03,7,2021,"13",1787065,324,10,297,27,314,0.559576736156771,1.51085718762328,0.0909090909090908
"United States","Idaho","ID",2021-04-04,2021-04-10,7,2021,"14",1787065,347,23,294,53,324,1.28702649316057,2.96575670163089,0.180272108843538
"United States","Idaho","ID",2021-04-11,2021-04-17,7,2021,"15",1787065,280,28,288,-8,252,1.56681486123896,-0.447661388925417,-0.0277777777777778
"United States","Idaho","ID",2021-04-18,2021-04-24,7,2021,"16",1787065,284,14,288,-4,270,0.783407430619479,-0.223830694462708,-0.0138888888888888
"United States","Idaho","ID",2021-04-25,2021-05-01,7,2021,"17",1787065,275,15,281,-6,260,0.839365104235157,-0.335746041694063,-0.0213523131672598
"United States","Idaho","ID",2021-05-02,2021-05-08,7,2021,"18",1787065,276,15,276,0,261,0.839365104235157,0,0
"United States","Idaho","ID",2021-05-09,2021-05-15,7,2021,"19",1787065,290,3,277,13,287,0.167873020847031,0.727449757003802,0.0469314079422383
"United States","Idaho","ID",2021-05-16,2021-05-22,7,2021,"20",1787065,330,16,280,50,314,0.895322777850834,2.79788368078386,0.178571428571429
"United States","Idaho","ID",2021-05-23,2021-05-29,7,2021,"21",1787065,326,10,280,46,316,0.559576736156771,2.57405298632115,0.164285714285714
"United States","Idaho","ID",2021-05-30,2021-06-05,7,2021,"22",1787065,295,11,281,14,284,0.615534409772448,0.783407430619479,0.0498220640569396
"United States","Idaho","ID",2021-06-06,2021-06-12,7,2021,"23",1787065,324,15,281,43,309,0.839365104235157,2.40617996547412,0.153024911032029
"United States","Idaho","ID",2021-06-13,2021-06-19,7,2021,"24",1787065,318,6,274,44,312,0.335746041694063,2.46213763908979,0.160583941605839
"United States","Idaho","ID",2021-06-20,2021-06-26,7,2021,"25",1787065,287,23,271,16,264,1.28702649316057,0.895322777850834,0.0590405904059041
"United States","Idaho","ID",2021-06-27,2021-07-03,7,2021,"26",1787065,280,13,269,11,267,0.727449757003802,0.615534409772448,0.0408921933085502
"United States","Idaho","ID",2021-07-04,2021-07-10,7,2021,"27",1787065,200,7,266,-66,193,0.39170371530974,-3.69320645863469,-0.24812030075188
"United States","Illinois","IL",2019-12-29,2020-01-04,7,2020,"1",12671821,2191,0,2367,-176,2191,0,-1.3889085080984,-0.0743557245458386
"United States","Illinois","IL",2020-01-05,2020-01-11,7,2020,"2",12671821,2252,0,2385,-133,2252,0,-1.049572906688,-0.0557651991614255
"United States","Illinois","IL",2020-01-12,2020-01-18,7,2020,"3",12671821,2231,0,2347,-116,2231,0,-0.915416971246674,-0.0494247976139753
"United States","Illinois","IL",2020-01-19,2020-01-25,7,2020,"4",12671821,2199,0,2346,-147,2199,0,-1.16005426528673,-0.0626598465473146
"United States","Illinois","IL",2020-01-26,2020-02-01,7,2020,"5",12671821,2137,0,2326,-189,2137,0,-1.49149834108294,-0.0812553740326741
"United States","Illinois","IL",2020-02-02,2020-02-08,7,2020,"6",12671821,2232,0,2308,-76,2232,0,-0.599755946678855,-0.0329289428076257
"United States","Illinois","IL",2020-02-09,2020-02-15,7,2020,"7",12671821,2216,0,2283,-67,2216,0,-0.528732216151096,-0.029347349978099
"United States","Illinois","IL",2020-02-16,2020-02-22,7,2020,"8",12671821,2207,0,2256,-49,2207,0,-0.386684755095578,-0.0217198581560284
"United States","Illinois","IL",2020-02-23,2020-02-29,7,2020,"9",12671821,2209,0,2222,-13,2209,0,-0.102589832984541,-0.00585058505850589
"United States","Illinois","IL",2020-03-01,2020-03-07,7,2020,"10",12671821,2254,0,2218,36,2254,0,0.284094922111037,0.0162308385933274
"United States","Illinois","IL",2020-03-08,2020-03-14,7,2020,"11",12671821,2191,0,2189,2,2191,0,0.0157830512283909,0.000913659205116435
"United States","Illinois","IL",2020-03-15,2020-03-21,7,2020,"12",12671821,2283,6,2169,114,2277,0.0473491536851728,0.899633920018283,0.0525587828492393
"United States","Illinois","IL",2020-03-22,2020-03-28,7,2020,"13",12671821,2304,41,2152,152,2263,0.323552550182014,1.19951189335771,0.0706319702602229
"United States","Illinois","IL",2020-03-29,2020-04-04,7,2020,"14",12671821,2622,197,2140,482,2425,1.55463054599651,3.80371534604221,0.225233644859813
"United States","Illinois","IL",2020-04-05,2020-04-11,7,2020,"15",12671821,2870,433,2109,761,2437,3.41703059094664,6.00545099240275,0.360834518729256
"United States","Illinois","IL",2020-04-12,2020-04-18,7,2020,"16",12671821,2912,582,2097,815,2330,4.59286790746176,6.4315933755693,0.388650453028135
"United States","Illinois","IL",2020-04-19,2020-04-25,7,2020,"17",12671821,3010,616,2066,944,2394,4.86117977834441,7.44960017980052,0.456921587608906
"United States","Illinois","IL",2020-04-26,2020-05-02,7,2020,"18",12671821,2952,679,2027,925,2273,5.35834589203872,7.29966119313081,0.456339417858905
"United States","Illinois","IL",2020-05-03,2020-05-09,7,2020,"19",12671821,2962,793,2003,959,2169,6.257979812057,7.56797306401345,0.478781827259111
"United States","Illinois","IL",2020-05-10,2020-05-16,7,2020,"20",12671821,2865,780,1966,899,2085,6.15538997907246,7.09448152716172,0.457273652085453
"United States","Illinois","IL",2020-05-17,2020-05-23,7,2020,"21",12671821,2638,663,1967,671,1975,5.23208148221159,5.29521368712516,0.341128622267412
"United States","Illinois","IL",2020-05-24,2020-05-30,7,2020,"22",12671821,2547,540,1970,577,2007,4.26142383166555,4.55341027939078,0.292893401015228
"United States","Illinois","IL",2020-05-31,2020-06-06,7,2020,"23",12671821,2511,533,1954,557,1978,4.20618315236618,4.39557976710687,0.285056294779939
"United States","Illinois","IL",2020-06-07,2020-06-13,7,2020,"24",12671821,2270,426,1952,318,1844,3.36178991164727,2.50950514531416,0.162909836065574
"United States","Illinois","IL",2020-06-14,2020-06-20,7,2020,"25",12671821,2255,336,1931,324,1919,2.65155260636968,2.55685429899933,0.167788710512688
"United States","Illinois","IL",2020-06-21,2020-06-27,7,2020,"26",12671821,2134,248,1941,193,1886,1.95709835232048,1.52306444353972,0.0994332818134982
"United States","Illinois","IL",2020-06-28,2020-07-04,7,2020,"27",12671821,2182,141,1932,250,2041,1.11270511160156,1.97288140354887,0.129399585921325
"United States","Illinois","IL",2020-07-05,2020-07-11,7,2020,"28",12671821,2189,154,1924,265,2035,1.2152949445861,2.0912542877618,0.137733887733888
"United States","Illinois","IL",2020-07-12,2020-07-18,7,2020,"29",12671821,2087,122,1909,178,1965,0.962766124931847,1.40469155932679,0.0932425353588267
"United States","Illinois","IL",2020-07-19,2020-07-25,7,2020,"30",12671821,2034,107,1903,131,1927,0.844393240718915,1.03378985545961,0.0688386757750921
"United States","Illinois","IL",2020-07-26,2020-08-01,7,2020,"31",12671821,2071,106,1889,182,1965,0.836501715104719,1.43625766178357,0.096347273689783
"United States","Illinois","IL",2020-08-02,2020-08-08,7,2020,"32",12671821,2138,128,1881,257,2010,1.01011527861702,2.02812208284823,0.136629452418926
"United States","Illinois","IL",2020-08-09,2020-08-15,7,2020,"33",12671821,2126,95,1880,246,2031,0.749694933348569,1.94131530109208,0.130851063829787
"United States","Illinois","IL",2020-08-16,2020-08-22,7,2020,"34",12671821,2151,148,1876,275,2003,1.16794579090093,2.17016954390375,0.146588486140725
"United States","Illinois","IL",2020-08-23,2020-08-29,7,2020,"35",12671821,2120,134,1889,231,1986,1.05746443230219,1.82294241687915,0.122286924298571
"United States","Illinois","IL",2020-08-30,2020-09-05,7,2020,"36",12671821,2198,158,1914,284,2040,1.24686104704288,2.24119327443151,0.148380355276907
"United States","Illinois","IL",2020-09-06,2020-09-12,7,2020,"37",12671821,2080,129,1932,148,1951,1.01800680423121,1.16794579090093,0.0766045548654244
"United States","Illinois","IL",2020-09-13,2020-09-19,7,2020,"38",12671821,2080,141,1946,134,1939,1.11270511160156,1.05746443230219,0.0688591983556013
"United States","Illinois","IL",2020-09-20,2020-09-26,7,2020,"39",12671821,2295,152,1956,339,2143,1.19951189335771,2.67522718321226,0.173312883435583
"United States","Illinois","IL",2020-09-27,2020-10-03,7,2020,"40",12671821,2138,186,1948,190,1952,1.46782376424036,1.49938986669714,0.0975359342915811
"United States","Illinois","IL",2020-10-04,2020-10-10,7,2020,"41",12671821,2333,201,1941,392,2132,1.58619664845329,3.09347804076462,0.201957753735188
"United States","Illinois","IL",2020-10-11,2020-10-17,7,2020,"42",12671821,2281,217,1943,338,2064,1.71246105828042,2.66733565759807,0.173957797220793
"United States","Illinois","IL",2020-10-18,2020-10-24,7,2020,"43",12671821,2290,289,1950,340,2001,2.28065090250249,2.68311870882646,0.174358974358974
"United States","Illinois","IL",2020-10-25,2020-10-31,7,2020,"44",12671821,2455,228,1950,505,2227,1.79926784003657,3.98522043516871,0.258974358974359
"United States","Illinois","IL",2020-11-01,2020-11-07,7,2020,"45",12671821,2699,444,1973,726,2255,3.50383737270279,5.72924759590591,0.367967562088191
"United States","Illinois","IL",2020-11-08,2020-11-14,7,2020,"46",12671821,2905,515,1985,920,2390,4.06413569131066,7.26020356505983,0.463476070528967
"United States","Illinois","IL",2020-11-15,2020-11-21,7,2020,"47",12671821,3186,762,1988,1198,2424,6.01334251801694,9.45404768580617,0.60261569416499
"United States","Illinois","IL",2020-11-22,2020-11-28,7,2020,"48",12671821,3151,707,2011,1140,2444,5.57930860923619,8.99633920018283,0.566882148184983
"United States","Illinois","IL",2020-11-29,2020-12-05,7,2020,"49",12671821,3282,1041,2035,1247,2241,8.21507816437748,9.84073244090174,0.612776412776413
"United States","Illinois","IL",2020-12-06,2020-12-12,7,2020,"50",12671821,3345,998,2043,1302,2347,7.87574256296707,10.2747663496825,0.637298091042585
"United States","Illinois","IL",2020-12-13,2020-12-19,7,2020,"51",12671821,3130,944,2077,1053,2186,7.44960017980052,8.30977647174783,0.50698122291767
"United States","Illinois","IL",2020-12-20,2020-12-26,7,2020,"52",12671821,3040,745,2112,928,2295,5.87918658257562,7.32333576997339,0.439393939393939
"United States","Illinois","IL",2020-12-27,2021-01-02,7,2020,"53",12671821,3031,802,2128,903,2229,6.32900354258476,7.12604762961851,0.424342105263158
"United States","Illinois","IL",2021-01-03,2021-01-09,7,2021,"1",12671821,2794,827,2167,627,1967,6.52629168293965,4.94798656010056,0.289340101522843
"United States","Illinois","IL",2021-01-10,2021-01-16,7,2021,"2",12671821,2733,684,2203,530,2049,5.3978035201097,4.1825085755236,0.240581025873808
"United States","Illinois","IL",2021-01-17,2021-01-23,7,2021,"3",12671821,2608,531,2195,413,2077,4.19040010113779,3.25920007866273,0.188154897494305
"United States","Illinois","IL",2021-01-24,2021-01-30,7,2021,"4",12671821,2593,494,2200,393,2099,3.89841365341256,3.10136956637882,0.178636363636364
"United States","Illinois","IL",2021-01-31,2021-02-06,7,2021,"5",12671821,2568,382,2195,373,2186,3.01456278462267,2.94353905409491,0.169931662870159
"United States","Illinois","IL",2021-02-07,2021-02-13,7,2021,"6",12671821,2483,344,2176,307,2139,2.71468481128324,2.42269836355801,0.141084558823529
"United States","Illinois","IL",2021-02-14,2021-02-20,7,2021,"7",12671821,2444,308,2139,305,2136,2.4305898891722,2.40691531232962,0.142589995324918
"United States","Illinois","IL",2021-02-21,2021-02-27,7,2021,"8",12671821,2339,260,2129,210,2079,2.05179665969082,1.65722037898105,0.0986378581493659
"United States","Illinois","IL",2021-02-28,2021-03-06,7,2021,"9",12671821,2184,258,2102,82,1926,2.03601360846243,0.647105100364028,0.0390104662226451
"United States","Illinois","IL",2021-03-07,2021-03-13,7,2021,"10",12671821,2113,174,2103,10,1939,1.37312545687001,0.0789152561419547,0.00475511174512611
"United States","Illinois","IL",2021-03-14,2021-03-20,7,2021,"11",12671821,2123,133,2082,41,1990,1.049572906688,0.323552550182014,0.0196926032660902
"United States","Illinois","IL",2021-03-21,2021-03-27,7,2021,"12",12671821,2135,171,2063,72,1964,1.34945088002742,0.568189844222074,0.0349006301502666
"United States","Illinois","IL",2021-03-28,2021-04-03,7,2021,"13",12671821,2187,2402,2058,129,-215,18.9554445252975,1.01800680423121,0.0626822157434401
"United States","Illinois","IL",2021-04-04,2021-04-10,7,2021,"14",12671821,2240,142,2038,202,2098,1.12059663721576,1.59408817406748,0.099116781157998
"United States","Illinois","IL",2021-04-11,2021-04-17,7,2021,"15",12671821,2118,168,2014,104,1950,1.32577630318484,0.820718663876329,0.051638530287984
"United States","Illinois","IL",2021-04-18,2021-04-24,7,2021,"16",12671821,2230,169,2005,225,2061,1.33366782879903,1.77559326319398,0.112219451371571
"United States","Illinois","IL",2021-04-25,2021-05-01,7,2021,"17",12671821,2247,216,1983,264,2031,1.70456953266622,2.0833627621476,0.133131618759455
"United States","Illinois","IL",2021-05-02,2021-05-08,7,2021,"18",12671821,2178,216,1976,202,1962,1.70456953266622,1.59408817406748,0.102226720647773
"United States","Illinois","IL",2021-05-09,2021-05-15,7,2021,"19",12671821,2152,179,1964,188,1973,1.41258308494099,1.48360681546875,0.0957230142566192
"United States","Illinois","IL",2021-05-16,2021-05-22,7,2021,"20",12671821,2236,210,1957,279,2026,1.65722037898105,2.20173564636054,0.14256515074093
"United States","Illinois","IL",2021-05-23,2021-05-29,7,2021,"21",12671821,2044,231,1924,120,1813,1.82294241687915,0.946983073703456,0.0623700623700623
"United States","Illinois","IL",2021-05-30,2021-06-05,7,2021,"22",12671821,2205,116,1914,291,2089,0.915416971246674,2.29643395373088,0.152037617554859
"United States","Illinois","IL",2021-06-06,2021-06-12,7,2021,"23",12671821,2126,187,1911,215,1939,1.47571528985455,1.69667800705203,0.11250654107797
"United States","Illinois","IL",2021-06-13,2021-06-19,7,2021,"24",12671821,2042,97,1896,146,1945,0.76547798457696,1.15216273967254,0.0770042194092826
"United States","Illinois","IL",2021-06-20,2021-06-26,7,2021,"25",12671821,1992,71,1879,113,1921,0.560298318607878,0.891742394404088,0.0601383714741883
"United States","Illinois","IL",2021-06-27,2021-07-03,7,2021,"26",12671821,1999,59,1885,114,1940,0.465600011237532,0.899633920018283,0.0604774535809018
"United States","Illinois","IL",2021-07-04,2021-07-10,7,2021,"27",12671821,1908,59,1878,30,1849,0.465600011237532,0.236745768425864,0.0159744408945688
"United States","Indiana","IN",2019-12-29,2020-01-04,7,2020,"1",6732219,1470,0,1485,-15,1470,0,-0.222809151039204,-0.0101010101010101
"United States","Indiana","IN",2020-01-05,2020-01-11,7,2020,"2",6732219,1386,0,1496,-110,1386,0,-1.6339337742875,-0.0735294117647058
"United States","Indiana","IN",2020-01-12,2020-01-18,7,2020,"3",6732219,1389,0,1492,-103,1389,0,-1.5299561704692,-0.0690348525469169
"United States","Indiana","IN",2020-01-19,2020-01-25,7,2020,"4",6732219,1422,0,1480,-58,1422,0,-0.86152871735159,-0.0391891891891892
"United States","Indiana","IN",2020-01-26,2020-02-01,7,2020,"5",6732219,1380,0,1444,-64,1380,0,-0.950652377767271,-0.0443213296398892
"United States","Indiana","IN",2020-02-02,2020-02-08,7,2020,"6",6732219,1363,0,1440,-77,1363,0,-1.14375364200125,-0.0534722222222223
"United States","Indiana","IN",2020-02-09,2020-02-15,7,2020,"7",6732219,1429,0,1417,12,1429,0,0.178247320831363,0.00846859562455893
"United States","Indiana","IN",2020-02-16,2020-02-22,7,2020,"8",6732219,1412,0,1411,1,1412,0,0.0148539434026136,0.000708717221828525
"United States","Indiana","IN",2020-02-23,2020-02-29,7,2020,"9",6732219,1449,0,1388,61,1449,0,0.90609054755943,0.0439481268011528
"United States","Indiana","IN",2020-03-01,2020-03-07,7,2020,"10",6732219,1372,0,1389,-17,1372,0,-0.252517037844431,-0.0122390208783297
"United States","Indiana","IN",2020-03-08,2020-03-14,7,2020,"11",6732219,1407,0,1382,25,1407,0,0.37134858506534,0.0180897250361796
"United States","Indiana","IN",2020-03-15,2020-03-21,7,2020,"12",6732219,1329,9,1380,-51,1320,0.133685490623523,-0.757551113533294,-0.0369565217391304
"United States","Indiana","IN",2020-03-22,2020-03-28,7,2020,"13",6732219,1486,38,1369,117,1448,0.564449849299317,1.73791137810579,0.0854638422205989
"United States","Indiana","IN",2020-03-29,2020-04-04,7,2020,"14",6732219,1581,138,1353,228,1443,2.04984418956068,3.3866990957959,0.168514412416851
"United States","Indiana","IN",2020-04-05,2020-04-11,7,2020,"15",6732219,1633,207,1336,297,1426,3.07476628434102,4.41162119057624,0.222305389221557
"United States","Indiana","IN",2020-04-12,2020-04-18,7,2020,"16",6732219,1510,224,1312,198,1286,3.32728332218545,2.94108079371749,0.150914634146341
"United States","Indiana","IN",2020-04-19,2020-04-25,7,2020,"17",6732219,1597,227,1292,305,1370,3.37184515239329,4.53045273779715,0.236068111455108
"United States","Indiana","IN",2020-04-26,2020-05-02,7,2020,"18",6732219,1537,272,1262,275,1265,4.0402726055109,4.08483443571874,0.217908082408875
"United States","Indiana","IN",2020-05-03,2020-05-09,7,2020,"19",6732219,1583,247,1232,351,1336,3.66892402044556,5.21373413431738,0.284902597402597
"United States","Indiana","IN",2020-05-10,2020-05-16,7,2020,"20",6732219,1572,234,1224,348,1338,3.47582275621158,5.16917230410954,0.284313725490196
"United States","Indiana","IN",2020-05-17,2020-05-23,7,2020,"21",6732219,1474,216,1214,260,1258,3.20845177496454,3.86202528467954,0.214168039538715
"United States","Indiana","IN",2020-05-24,2020-05-30,7,2020,"22",6732219,1383,131,1218,165,1252,1.94586658574238,2.45090066143125,0.135467980295567
"United States","Indiana","IN",2020-05-31,2020-06-06,7,2020,"23",6732219,1396,167,1202,194,1229,2.48060854823647,2.88166502010704,0.161397670549085
"United States","Indiana","IN",2020-06-07,2020-06-13,7,2020,"24",6732219,1392,121,1199,193,1271,1.79732715171625,2.86681107670443,0.160967472894078
"United States","Indiana","IN",2020-06-14,2020-06-20,7,2020,"25",6732219,1353,115,1198,155,1238,1.70820349130057,2.30236122740511,0.129382303839733
"United States","Indiana","IN",2020-06-21,2020-06-27,7,2020,"26",6732219,1380,78,1196,184,1302,1.15860758540386,2.7331255860809,0.153846153846154
"United States","Indiana","IN",2020-06-28,2020-07-04,7,2020,"27",6732219,1345,70,1192,153,1275,1.03977603818295,2.27265334059988,0.128355704697987
"United States","Indiana","IN",2020-07-05,2020-07-11,7,2020,"28",6732219,1352,69,1195,157,1283,1.02492209478034,2.33206911421034,0.131380753138075
"United States","Indiana","IN",2020-07-12,2020-07-18,7,2020,"29",6732219,1383,64,1182,201,1319,0.950652377767271,2.98564262392534,0.17005076142132
"United States","Indiana","IN",2020-07-19,2020-07-25,7,2020,"30",6732219,1318,71,1176,142,1247,1.05462998158557,2.10925996317113,0.120748299319728
"United States","Indiana","IN",2020-07-26,2020-08-01,7,2020,"31",6732219,1367,73,1169,198,1294,1.08433786839079,2.94108079371749,0.169375534644996
"United States","Indiana","IN",2020-08-02,2020-08-08,7,2020,"32",6732219,1344,63,1171,173,1281,0.935798434364657,2.56973220865215,0.147736976942784
"United States","Indiana","IN",2020-08-09,2020-08-15,7,2020,"33",6732219,1372,87,1168,204,1285,1.29229307602738,3.03020445413318,0.174657534246575
"United States","Indiana","IN",2020-08-16,2020-08-22,7,2020,"34",6732219,1359,80,1165,194,1279,1.18831547220909,2.88166502010704,0.166523605150215
"United States","Indiana","IN",2020-08-23,2020-08-29,7,2020,"35",6732219,1356,284,1165,191,1072,4.21851992634227,2.8371031898992,0.163948497854077
"United States","Indiana","IN",2020-08-30,2020-09-05,7,2020,"36",6732219,1271,77,1174,97,1194,1.14375364200125,1.44083251005352,0.0826235093696763
"United States","Indiana","IN",2020-09-06,2020-09-12,7,2020,"37",6732219,1343,75,1168,175,1268,1.11404575519602,2.59944009545738,0.149828767123288
"United States","Indiana","IN",2020-09-13,2020-09-19,7,2020,"38",6732219,1409,66,1169,240,1343,0.980360264572498,3.56494641662727,0.205303678357571
"United States","Indiana","IN",2020-09-20,2020-09-26,7,2020,"39",6732219,1441,74,1170,271,1367,1.09919181179341,4.02541866210829,0.231623931623932
"United States","Indiana","IN",2020-09-27,2020-10-03,7,2020,"40",6732219,1411,92,1179,232,1319,1.36656279304045,3.44611486940636,0.196776929601357
"United States","Indiana","IN",2020-10-04,2020-10-10,7,2020,"41",6732219,1442,113,1188,254,1329,1.67849560449534,3.77290162426386,0.213804713804714
"United States","Indiana","IN",2020-10-11,2020-10-17,7,2020,"42",6732219,1524,136,1199,325,1388,2.02013630275545,4.82753160584942,0.271059216013344
"United States","Indiana","IN",2020-10-18,2020-10-24,7,2020,"43",6732219,1514,200,1200,314,1314,2.97078868052272,4.66413822842067,0.261666666666667
"United States","Indiana","IN",2020-10-25,2020-10-31,7,2020,"44",6732219,1600,213,1213,387,1387,3.1638899447567,5.74847609681147,0.319043693322341
"United States","Indiana","IN",2020-11-01,2020-11-07,7,2020,"45",6732219,1655,260,1220,435,1395,3.86202528467954,6.46146538013692,0.35655737704918
"United States","Indiana","IN",2020-11-08,2020-11-14,7,2020,"46",6732219,1721,296,1230,491,1425,4.39676724717363,7.29328621068328,0.399186991869919
"United States","Indiana","IN",2020-11-15,2020-11-21,7,2020,"47",6732219,1936,359,1233,703,1577,5.33256568153829,10.4423222120374,0.570154095701541
"United States","Indiana","IN",2020-11-22,2020-11-28,7,2020,"48",6732219,2015,417,1254,761,1598,6.19409439888988,11.303850929389,0.606858054226475
"United States","Indiana","IN",2020-11-29,2020-12-05,7,2020,"49",6732219,1943,544,1271,672,1399,8.08054521102181,9.98184996655635,0.528717545239969
"United States","Indiana","IN",2020-12-06,2020-12-12,7,2020,"50",6732219,2119,550,1299,820,1569,8.16966887143749,12.1802335901432,0.63125481139338
"United States","Indiana","IN",2020-12-13,2020-12-19,7,2020,"51",6732219,2060,581,1320,740,1479,8.63014111691851,10.9919181179341,0.560606060606061
"United States","Indiana","IN",2020-12-20,2020-12-26,7,2020,"52",6732219,2010,463,1341,669,1547,6.8773757954101,9.9372881363485,0.498881431767338
"United States","Indiana","IN",2020-12-27,2021-01-02,7,2020,"53",6732219,2047,609,1360,687,1438,9.04605153219169,10.2046591175956,0.505147058823529
"United States","Indiana","IN",2021-01-03,2021-01-09,7,2021,"1",6732219,1969,556,1382,587,1413,8.25879253185317,8.71926477733419,0.424746743849493
"United States","Indiana","IN",2021-01-10,2021-01-16,7,2021,"2",6732219,1908,321,1390,518,1587,4.76811583223897,7.69434268255385,0.372661870503597
"United States","Indiana","IN",2021-01-17,2021-01-23,7,2021,"3",6732219,1785,405,1394,391,1380,6.01584707805851,5.80789187042192,0.280487804878049
"United States","Indiana","IN",2021-01-24,2021-01-30,7,2021,"4",6732219,1636,275,1392,244,1361,4.08483443571874,3.62436219023772,0.175287356321839
"United States","Indiana","IN",2021-01-31,2021-02-06,7,2021,"5",6732219,1617,1785,1387,230,-168,26.5142889736653,3.41640698260113,0.165825522710887
"United States","Indiana","IN",2021-02-07,2021-02-13,7,2021,"6",6732219,1511,397,1378,133,1114,5.8970155308376,1.97557447254761,0.0965166908563135
"United States","Indiana","IN",2021-02-14,2021-02-20,7,2021,"7",6732219,1471,189,1357,114,1282,2.80739530309397,1.69334954789795,0.084008843036109
"United States","Indiana","IN",2021-02-21,2021-02-27,7,2021,"8",6732219,1445,222,1345,100,1223,3.29757543538022,1.48539434026136,0.0743494423791822
"United States","Indiana","IN",2021-02-28,2021-03-06,7,2021,"9",6732219,1416,168,1338,78,1248,2.49546249163909,1.15860758540386,0.0582959641255605
"United States","Indiana","IN",2021-03-07,2021-03-13,7,2021,"10",6732219,1383,119,1332,51,1264,1.76761926491102,0.757551113533294,0.0382882882882882
"United States","Indiana","IN",2021-03-14,2021-03-20,7,2021,"11",6732219,1311,82,1334,-23,1229,1.21802335901432,-0.341640698260113,-0.0172413793103449
"United States","Indiana","IN",2021-03-21,2021-03-27,7,2021,"12",6732219,1300,85,1329,-29,1215,1.26258518922216,-0.430764358675795,-0.0218209179834462
"United States","Indiana","IN",2021-03-28,2021-04-03,7,2021,"13",6732219,1285,64,1326,-41,1221,0.950652377767271,-0.609011679507158,-0.030920060331825
"United States","Indiana","IN",2021-04-04,2021-04-10,7,2021,"14",6732219,1374,60,1318,56,1314,0.891236604156817,0.831820830546362,0.0424886191198786
"United States","Indiana","IN",2021-04-11,2021-04-17,7,2021,"15",6732219,1392,78,1305,87,1314,1.15860758540386,1.29229307602738,0.0666666666666667
"United States","Indiana","IN",2021-04-18,2021-04-24,7,2021,"16",6732219,1279,55,1284,-5,1224,0.816966887143749,-0.0742697170130681,-0.00389408099688471
"United States","Indiana","IN",2021-04-25,2021-05-01,7,2021,"17",6732219,1352,67,1279,73,1285,0.995214207975112,1.08433786839079,0.0570758405003908
"United States","Indiana","IN",2021-05-02,2021-05-08,7,2021,"18",6732219,1318,67,1271,47,1251,0.995214207975112,0.69813533992284,0.0369787568843429
"United States","Indiana","IN",2021-05-09,2021-05-15,7,2021,"19",6732219,1283,66,1257,26,1217,0.980360264572498,0.386202528467954,0.020684168655529
"United States","Indiana","IN",2021-05-16,2021-05-22,7,2021,"20",6732219,1333,82,1247,86,1251,1.21802335901432,1.27743913262477,0.0689655172413792
"United States","Indiana","IN",2021-05-23,2021-05-29,7,2021,"21",6732219,1301,62,1232,69,1239,0.920944490962044,1.02492209478034,0.0560064935064934
"United States","Indiana","IN",2021-05-30,2021-06-05,7,2021,"22",6732219,1348,70,1228,120,1278,1.03977603818295,1.78247320831363,0.0977198697068404
"United States","Indiana","IN",2021-06-06,2021-06-12,7,2021,"23",6732219,1249,60,1219,30,1189,0.891236604156817,0.445618302078408,0.0246103363412633
"United States","Indiana","IN",2021-06-13,2021-06-19,7,2021,"24",6732219,1349,50,1225,124,1299,0.742697170130681,1.84188898192409,0.101224489795918
"United States","Indiana","IN",2021-06-20,2021-06-26,7,2021,"25",6732219,1194,27,1232,-38,1167,0.401056471870568,-0.564449849299317,-0.0308441558441559
"United States","Indiana","IN",2021-06-27,2021-07-03,7,2021,"26",6732219,1160,41,1227,-67,1119,0.609011679507158,-0.995214207975112,-0.0546047269763651
"United States","Indiana","IN",2021-07-04,2021-07-10,7,2021,"27",6732219,878,51,1213,-335,827,0.757551113533294,-4.97607103987556,-0.276174773289365
"United States","Iowa","IA",2019-12-29,2020-01-04,7,2020,"1",3155070,665,0,684,-19,665,0,-0.602205339342709,-0.0277777777777778
"United States","Iowa","IA",2020-01-05,2020-01-11,7,2020,"2",3155070,647,0,691,-44,647,0,-1.39458078584627,-0.0636758321273516
"United States","Iowa","IA",2020-01-12,2020-01-18,7,2020,"3",3155070,620,0,687,-67,620,0,-2.12356619662955,-0.0975254730713246
"United States","Iowa","IA",2020-01-19,2020-01-25,7,2020,"4",3155070,640,0,678,-38,640,0,-1.20441067868542,-0.056047197640118
"United States","Iowa","IA",2020-01-26,2020-02-01,7,2020,"5",3155070,615,0,675,-60,615,0,-1.90170107160855,-0.0888888888888889
"United States","Iowa","IA",2020-02-02,2020-02-08,7,2020,"6",3155070,637,0,667,-30,637,0,-0.950850535804277,-0.0449775112443778
"United States","Iowa","IA",2020-02-09,2020-02-15,7,2020,"7",3155070,600,0,657,-57,600,0,-1.80661601802813,-0.08675799086758
"United States","Iowa","IA",2020-02-16,2020-02-22,7,2020,"8",3155070,643,0,647,-4,643,0,-0.12678007144057,-0.00618238021638329
"United States","Iowa","IA",2020-02-23,2020-02-29,7,2020,"9",3155070,642,0,635,7,642,0,0.221865125020998,0.0110236220472442
"United States","Iowa","IA",2020-03-01,2020-03-07,7,2020,"10",3155070,624,0,631,-7,624,0,-0.221865125020998,-0.0110935023771791
"United States","Iowa","IA",2020-03-08,2020-03-14,7,2020,"11",3155070,636,0,619,17,636,0,0.538815303622424,0.0274636510500808
"United States","Iowa","IA",2020-03-15,2020-03-21,7,2020,"12",3155070,598,0,612,-14,598,0,-0.443730250041996,-0.0228758169934641
"United States","Iowa","IA",2020-03-22,2020-03-28,7,2020,"13",3155070,595,3,607,-12,592,0.0950850535804277,-0.380340214321711,-0.0197693574958814
"United States","Iowa","IA",2020-03-29,2020-04-04,7,2020,"14",3155070,608,8,600,8,600,0.25356014288114,0.25356014288114,0.0133333333333334
"United States","Iowa","IA",2020-04-05,2020-04-11,7,2020,"15",3155070,597,23,595,2,574,0.728985410783279,0.0633900357202851,0.00336134453781511
"United States","Iowa","IA",2020-04-12,2020-04-18,7,2020,"16",3155070,633,40,591,42,593,1.2678007144057,1.33119075012599,0.0710659898477157
"United States","Iowa","IA",2020-04-19,2020-04-25,7,2020,"17",3155070,587,38,593,-6,549,1.20441067868542,-0.190170107160855,-0.0101180438448567
"United States","Iowa","IA",2020-04-26,2020-05-02,7,2020,"18",3155070,673,63,590,83,610,1.99678612518898,2.63068648239183,0.140677966101695
"United States","Iowa","IA",2020-05-03,2020-05-09,7,2020,"19",3155070,702,76,582,120,626,2.40882135737083,3.80340214321711,0.206185567010309
"United States","Iowa","IA",2020-05-10,2020-05-16,7,2020,"20",3155070,674,95,568,106,579,3.01102669671354,3.35967189317511,0.186619718309859
"United States","Iowa","IA",2020-05-17,2020-05-23,7,2020,"21",3155070,619,98,550,69,521,3.10611175029397,2.18695623234984,0.125454545454545
"United States","Iowa","IA",2020-05-24,2020-05-30,7,2020,"22",3155070,632,83,547,85,549,2.63068648239183,2.69407651811212,0.155393053016453
"United States","Iowa","IA",2020-05-31,2020-06-06,7,2020,"23",3155070,600,71,549,51,529,2.25034626807012,1.61644591086727,0.0928961748633881
"United States","Iowa","IA",2020-06-07,2020-06-13,7,2020,"24",3155070,589,51,545,44,538,1.61644591086727,1.39458078584627,0.0807339449541284
"United States","Iowa","IA",2020-06-14,2020-06-20,7,2020,"25",3155070,575,32,548,27,543,1.01424057152456,0.855765482223849,0.0492700729927007
"United States","Iowa","IA",2020-06-21,2020-06-27,7,2020,"26",3155070,552,23,542,10,529,0.728985410783279,0.316950178601426,0.018450184501845
"United States","Iowa","IA",2020-06-28,2020-07-04,7,2020,"27",3155070,596,17,527,69,579,0.538815303622424,2.18695623234984,0.130929791271347
"United States","Iowa","IA",2020-07-05,2020-07-11,7,2020,"28",3155070,567,27,518,49,540,0.855765482223849,1.55305587514699,0.0945945945945945
"United States","Iowa","IA",2020-07-12,2020-07-18,7,2020,"29",3155070,601,39,519,82,562,1.23610569654556,2.59899146453169,0.157996146435453
"United States","Iowa","IA",2020-07-19,2020-07-25,7,2020,"30",3155070,651,39,514,137,612,1.23610569654556,4.34221744683953,0.266536964980545
"United States","Iowa","IA",2020-07-26,2020-08-01,7,2020,"31",3155070,650,46,516,134,604,1.45797082156656,4.2471323932591,0.25968992248062
"United States","Iowa","IA",2020-08-02,2020-08-08,7,2020,"32",3155070,649,53,513,136,596,1.67983594658756,4.31052242897939,0.265107212475634
"United States","Iowa","IA",2020-08-09,2020-08-15,7,2020,"33",3155070,669,48,519,150,621,1.52136085728684,4.75425267902139,0.289017341040462
"United States","Iowa","IA",2020-08-16,2020-08-22,7,2020,"34",3155070,625,57,519,106,568,1.80661601802813,3.35967189317511,0.204238921001927
"United States","Iowa","IA",2020-08-23,2020-08-29,7,2020,"35",3155070,691,78,522,169,613,2.47221139309112,5.35645801836409,0.323754789272031
"United States","Iowa","IA",2020-08-30,2020-09-05,7,2020,"36",3155070,597,52,527,70,545,1.64814092872741,2.21865125020998,0.132827324478178
"United States","Iowa","IA",2020-09-06,2020-09-12,7,2020,"37",3155070,637,48,533,104,589,1.52136085728684,3.29628185745483,0.195121951219512
"United States","Iowa","IA",2020-09-13,2020-09-19,7,2020,"38",3155070,642,56,531,111,586,1.77492100016798,3.51814698247582,0.209039548022599
"United States","Iowa","IA",2020-09-20,2020-09-26,7,2020,"39",3155070,641,47,536,105,594,1.4896658394267,3.32797687531497,0.19589552238806
"United States","Iowa","IA",2020-09-27,2020-10-03,7,2020,"40",3155070,680,66,547,133,614,2.09187117876941,4.21543737539896,0.243144424131627
"United States","Iowa","IA",2020-10-04,2020-10-10,7,2020,"41",3155070,733,77,570,163,656,2.44051637523098,5.16628791120324,0.285964912280702
"United States","Iowa","IA",2020-10-11,2020-10-17,7,2020,"42",3155070,688,72,567,121,616,2.28204128593026,3.83509716107725,0.213403880070547
"United States","Iowa","IA",2020-10-18,2020-10-24,7,2020,"43",3155070,750,103,563,187,647,3.26458683959468,5.92696833984666,0.33214920071048
"United States","Iowa","IA",2020-10-25,2020-10-31,7,2020,"44",3155070,759,86,569,190,673,2.72577153597226,6.02205339342709,0.333919156414763
"United States","Iowa","IA",2020-11-01,2020-11-07,7,2020,"45",3155070,860,100,568,292,760,3.16950178601426,9.25494521516163,0.514084507042254
"United States","Iowa","IA",2020-11-08,2020-11-14,7,2020,"46",3155070,905,154,579,326,751,4.88103275046196,10.3325758224065,0.563039723661485
"United States","Iowa","IA",2020-11-15,2020-11-21,7,2020,"47",3155070,998,186,584,414,812,5.89527332198652,13.121737394099,0.708904109589041
"United States","Iowa","IA",2020-11-22,2020-11-28,7,2020,"48",3155070,976,192,578,398,784,6.08544342914737,12.6146171083367,0.688581314878893
"United States","Iowa","IA",2020-11-29,2020-12-05,7,2020,"49",3155070,1002,279,579,423,723,8.84290998297977,13.4069925548403,0.730569948186528
"United States","Iowa","IA",2020-12-06,2020-12-12,7,2020,"50",3155070,950,582,585,365,368,18.446500394603,11.568681518952,0.623931623931624
"United States","Iowa","IA",2020-12-13,2020-12-19,7,2020,"51",3155070,864,242,596,268,622,7.6701943221545,8.49426478651821,0.449664429530201
"United States","Iowa","IA",2020-12-20,2020-12-26,7,2020,"52",3155070,834,293,602,232,541,9.28664023302177,7.35324414355307,0.385382059800665
"United States","Iowa","IA",2020-12-27,2021-01-02,7,2020,"53",3155070,743,201,616,127,542,6.37069858988866,4.02526726823811,0.206168831168831
"United States","Iowa","IA",2021-01-03,2021-01-09,7,2021,"1",3155070,799,183,628,171,616,5.80018826840609,5.41984805408438,0.272292993630573
"United States","Iowa","IA",2021-01-10,2021-01-16,7,2021,"2",3155070,754,194,632,122,560,6.14883346486766,3.86679217893739,0.193037974683544
"United States","Iowa","IA",2021-01-17,2021-01-23,7,2021,"3",3155070,746,165,632,114,581,5.22967794692352,3.61323203605625,0.180379746835443
"United States","Iowa","IA",2021-01-24,2021-01-30,7,2021,"4",3155070,649,165,633,16,484,5.22967794692352,0.507120285762281,0.0252764612954186
"United States","Iowa","IA",2021-01-31,2021-02-06,7,2021,"5",3155070,655,457,634,21,198,14.4846231620852,0.665595375062994,0.0331230283911672
"United States","Iowa","IA",2021-02-07,2021-02-13,7,2021,"6",3155070,613,128,631,-18,485,4.05696228609825,-0.570510321482566,-0.028526148969889
"United States","Iowa","IA",2021-02-14,2021-02-20,7,2021,"7",3155070,664,100,630,34,564,3.16950178601426,1.07763060724485,0.053968253968254
"United States","Iowa","IA",2021-02-21,2021-02-27,7,2021,"8",3155070,590,135,636,-46,455,4.27882741111925,-1.45797082156656,-0.0723270440251572
"United States","Iowa","IA",2021-02-28,2021-03-06,7,2021,"9",3155070,623,79,635,-12,544,2.50390641095126,-0.380340214321711,-0.0188976377952756
"United States","Iowa","IA",2021-03-07,2021-03-13,7,2021,"10",3155070,563,84,621,-58,479,2.66238150025198,-1.83831103588827,-0.0933977455716586
"United States","Iowa","IA",2021-03-14,2021-03-20,7,2021,"11",3155070,506,40,612,-106,466,1.2678007144057,-3.35967189317511,-0.173202614379085
"United States","Iowa","IA",2021-03-21,2021-03-27,7,2021,"12",3155070,568,43,612,-44,525,1.36288576798613,-1.39458078584627,-0.0718954248366013
"United States","Iowa","IA",2021-03-28,2021-04-03,7,2021,"13",3155070,578,38,614,-36,540,1.20441067868542,-1.14102064296513,-0.0586319218241043
"United States","Iowa","IA",2021-04-04,2021-04-10,7,2021,"14",3155070,632,94,604,28,538,2.9793316788534,0.887460500083992,0.0463576158940397
"United States","Iowa","IA",2021-04-11,2021-04-17,7,2021,"15",3155070,575,32,598,-23,543,1.01424057152456,-0.728985410783279,-0.0384615384615384
"United States","Iowa","IA",2021-04-18,2021-04-24,7,2021,"16",3155070,617,26,600,17,591,0.824070464363707,0.538815303622424,0.0283333333333333
"United States","Iowa","IA",2021-04-25,2021-05-01,7,2021,"17",3155070,637,43,591,46,594,1.36288576798613,1.45797082156656,0.0778341793570221
"United States","Iowa","IA",2021-05-02,2021-05-08,7,2021,"18",3155070,572,33,586,-14,539,1.0459355893847,-0.443730250041996,-0.0238907849829352
"United States","Iowa","IA",2021-05-09,2021-05-15,7,2021,"19",3155070,558,15,589,-31,543,0.475425267902138,-0.982545553664419,-0.0526315789473685
"United States","Iowa","IA",2021-05-16,2021-05-22,7,2021,"20",3155070,530,36,581,-51,494,1.14102064296513,-1.61644591086727,-0.0877796901893287
"United States","Iowa","IA",2021-05-23,2021-05-29,7,2021,"21",3155070,579,19,576,3,560,0.602205339342709,0.0950850535804277,0.00520833333333326
"United States","Iowa","IA",2021-05-30,2021-06-05,7,2021,"22",3155070,542,14,578,-36,528,0.443730250041996,-1.14102064296513,-0.0622837370242214
"United States","Iowa","IA",2021-06-06,2021-06-12,7,2021,"23",3155070,565,30,574,-9,535,0.950850535804277,-0.285255160741283,-0.0156794425087108
"United States","Iowa","IA",2021-06-13,2021-06-19,7,2021,"24",3155070,566,12,575,-9,554,0.380340214321711,-0.285255160741283,-0.0156521739130435
"United States","Iowa","IA",2021-06-20,2021-06-26,7,2021,"25",3155070,556,16,580,-24,540,0.507120285762281,-0.760680428643422,-0.0413793103448276
"United States","Iowa","IA",2021-06-27,2021-07-03,7,2021,"26",3155070,481,17,567,-86,464,0.538815303622424,-2.72577153597226,-0.151675485008818
"United States","Iowa","IA",2021-07-04,2021-07-10,7,2021,"27",3155070,452,7,556,-104,445,0.221865125020998,-3.29628185745483,-0.18705035971223
"United States","Kansas","KS",2019-12-29,2020-01-04,7,2020,"1",2913314,591,0,612,-21,591,0,-0.720828582157639,-0.0343137254901961
"United States","Kansas","KS",2020-01-05,2020-01-11,7,2020,"2",2913314,560,0,562,-2,560,0,-0.0686503411578704,-0.00355871886120995
"United States","Kansas","KS",2020-01-12,2020-01-18,7,2020,"3",2913314,576,0,610,-34,576,0,-1.1670557996838,-0.0557377049180328
"United States","Kansas","KS",2020-01-19,2020-01-25,7,2020,"4",2913314,571,0,600,-29,571,0,-0.995429946789121,-0.0483333333333333
"United States","Kansas","KS",2020-01-26,2020-02-01,7,2020,"5",2913314,549,0,594,-45,549,0,-1.54463267605208,-0.0757575757575758
"United States","Kansas","KS",2020-02-02,2020-02-08,7,2020,"6",2913314,503,0,589,-86,503,0,-2.95196466978843,-0.146010186757216
"United States","Kansas","KS",2020-02-09,2020-02-15,7,2020,"7",2913314,575,0,579,-4,575,0,-0.137300682315741,-0.00690846286701208
"United States","Kansas","KS",2020-02-16,2020-02-22,7,2020,"8",2913314,559,0,577,-18,559,0,-0.617853070420833,-0.0311958405545927
"United States","Kansas","KS",2020-02-23,2020-02-29,7,2020,"9",2913314,548,0,572,-24,548,0,-0.823804093894445,-0.041958041958042
"United States","Kansas","KS",2020-03-01,2020-03-07,7,2020,"10",2913314,575,0,564,11,575,0,0.377576876368287,0.0195035460992907
"United States","Kansas","KS",2020-03-08,2020-03-14,7,2020,"11",2913314,522,1,556,-34,521,0.0343251705789352,-1.1670557996838,-0.0611510791366906
"United States","Kansas","KS",2020-03-15,2020-03-21,7,2020,"12",2913314,515,1,545,-30,514,0.0343251705789352,-1.02975511736806,-0.055045871559633
"United States","Kansas","KS",2020-03-22,2020-03-28,7,2020,"13",2913314,523,3,537,-14,520,0.102975511736806,-0.480552388105093,-0.0260707635009311
"United States","Kansas","KS",2020-03-29,2020-04-04,7,2020,"14",2913314,550,16,524,26,534,0.549202729262963,0.892454435052315,0.0496183206106871
"United States","Kansas","KS",2020-04-05,2020-04-11,7,2020,"15",2913314,525,34,513,12,491,1.1670557996838,0.411902046947222,0.0233918128654971
"United States","Kansas","KS",2020-04-12,2020-04-18,7,2020,"16",2913314,546,32,505,41,514,1.09840545852593,1.40733199373634,0.0811881188118813
"United States","Kansas","KS",2020-04-19,2020-04-25,7,2020,"17",2913314,541,33,501,40,508,1.13273062910486,1.37300682315741,0.0798403193612773
"United States","Kansas","KS",2020-04-26,2020-05-02,7,2020,"18",2913314,526,22,499,27,504,0.755153752736574,0.92677960563125,0.0541082164328657
"United States","Kansas","KS",2020-05-03,2020-05-09,7,2020,"19",2913314,507,31,493,14,476,1.06408028794699,0.480552388105093,0.028397565922921
"United States","Kansas","KS",2020-05-10,2020-05-16,7,2020,"20",2913314,530,21,486,44,509,0.720828582157639,1.51030750547315,0.0905349794238683
"United States","Kansas","KS",2020-05-17,2020-05-23,7,2020,"21",2913314,520,10,483,37,510,0.343251705789352,1.2700313114206,0.0766045548654244
"United States","Kansas","KS",2020-05-24,2020-05-30,7,2020,"22",2913314,506,9,481,25,497,0.308926535210417,0.85812926447338,0.0519750519750519
"United States","Kansas","KS",2020-05-31,2020-06-06,7,2020,"23",2913314,499,19,477,22,480,0.652178240999769,0.755153752736574,0.0461215932914045
"United States","Kansas","KS",2020-06-07,2020-06-13,7,2020,"24",2913314,516,11,480,36,505,0.377576876368287,1.23570614084167,0.075
"United States","Kansas","KS",2020-06-14,2020-06-20,7,2020,"25",2913314,508,19,478,30,489,0.652178240999769,1.02975511736806,0.0627615062761506
"United States","Kansas","KS",2020-06-21,2020-06-27,7,2020,"26",2913314,521,6,480,41,515,0.205951023473611,1.40733199373634,0.0854166666666667
"United States","Kansas","KS",2020-06-28,2020-07-04,7,2020,"27",2913314,562,7,478,84,555,0.240276194052546,2.88331432863056,0.175732217573222
"United States","Kansas","KS",2020-07-05,2020-07-11,7,2020,"28",2913314,504,13,482,22,491,0.446227217526157,0.755153752736574,0.045643153526971
"United States","Kansas","KS",2020-07-12,2020-07-18,7,2020,"29",2913314,518,17,479,39,501,0.583527899841898,1.33868165257847,0.081419624217119
"United States","Kansas","KS",2020-07-19,2020-07-25,7,2020,"30",2913314,540,19,474,66,521,0.652178240999769,2.26546125820972,0.139240506329114
"United States","Kansas","KS",2020-07-26,2020-08-01,7,2020,"31",2913314,543,34,474,69,509,1.1670557996838,2.36843676994653,0.145569620253165
"United States","Kansas","KS",2020-08-02,2020-08-08,7,2020,"32",2913314,601,22,473,128,579,0.755153752736574,4.3936218341037,0.27061310782241
"United States","Kansas","KS",2020-08-09,2020-08-15,7,2020,"33",2913314,577,27,465,112,550,0.92677960563125,3.84441910484074,0.240860215053764
"United States","Kansas","KS",2020-08-16,2020-08-22,7,2020,"34",2913314,514,23,468,46,491,0.78947892331551,1.57895784663102,0.0982905982905984
"United States","Kansas","KS",2020-08-23,2020-08-29,7,2020,"35",2913314,532,18,471,61,514,0.617853070420833,2.09383540531505,0.129511677282378
"United States","Kansas","KS",2020-08-30,2020-09-05,7,2020,"36",2913314,566,33,473,93,533,1.13273062910486,3.19224086384097,0.19661733615222
"United States","Kansas","KS",2020-09-06,2020-09-12,7,2020,"37",2913314,581,41,471,110,540,1.40733199373634,3.77576876368287,0.233545647558386
"United States","Kansas","KS",2020-09-13,2020-09-19,7,2020,"38",2913314,553,76,478,75,477,2.60871296399907,2.57438779342014,0.156903765690377
"United States","Kansas","KS",2020-09-20,2020-09-26,7,2020,"39",2913314,601,34,477,124,567,1.1670557996838,4.25632115178796,0.259958071278826
"United States","Kansas","KS",2020-09-27,2020-10-03,7,2020,"40",2913314,580,66,477,103,514,2.26546125820972,3.53549256963032,0.215932914046122
"United States","Kansas","KS",2020-10-04,2020-10-10,7,2020,"41",2913314,638,65,479,159,573,2.23113608763079,5.4577021220507,0.331941544885177
"United States","Kansas","KS",2020-10-11,2020-10-17,7,2020,"42",2913314,636,96,481,155,540,3.29521637557778,5.32040143973495,0.322245322245322
"United States","Kansas","KS",2020-10-18,2020-10-24,7,2020,"43",2913314,658,116,482,176,542,3.98171978715648,6.04123002189259,0.365145228215768
"United States","Kansas","KS",2020-10-25,2020-10-31,7,2020,"44",2913314,577,54,490,87,523,1.8535592112625,2.98628984036736,0.177551020408163
"United States","Kansas","KS",2020-11-01,2020-11-07,7,2020,"45",2913314,679,137,502,177,542,4.70254836931412,6.07555519247153,0.352589641434263
"United States","Kansas","KS",2020-11-08,2020-11-14,7,2020,"46",2913314,719,88,503,216,631,3.0206150109463,7.41423684505,0.429423459244533
"United States","Kansas","KS",2020-11-15,2020-11-21,7,2020,"47",2913314,782,156,509,273,626,5.35472661031389,9.37077156804931,0.536345776031434
"United States","Kansas","KS",2020-11-22,2020-11-28,7,2020,"48",2913314,814,119,518,296,695,4.08469529889329,10.1602504913648,0.571428571428571
"United States","Kansas","KS",2020-11-29,2020-12-05,7,2020,"49",2913314,870,257,524,346,613,8.82156883878634,11.8765090203116,0.66030534351145
"United States","Kansas","KS",2020-12-06,2020-12-12,7,2020,"50",2913314,880,286,530,350,594,9.81699878557547,12.0138097026273,0.660377358490566
"United States","Kansas","KS",2020-12-13,2020-12-19,7,2020,"51",2913314,931,269,543,388,662,9.23347088573357,13.3181661846269,0.714548802946593
"United States","Kansas","KS",2020-12-20,2020-12-26,7,2020,"52",2913314,855,0,559,296,855,0,10.1602504913648,0.529516994633274
"United States","Kansas","KS",2020-12-27,2021-01-02,7,2020,"53",2913314,811,537,565,246,274,18.4326166008882,8.44399196241806,0.435398230088496
"United States","Kansas","KS",2021-01-03,2021-01-09,7,2021,"1",2913314,789,270,570,219,519,9.2677960563125,7.51721235678681,0.38421052631579
"United States","Kansas","KS",2021-01-10,2021-01-16,7,2021,"2",2913314,787,354,581,206,433,12.1511103849431,7.07098513926065,0.354561101549053
"United States","Kansas","KS",2021-01-17,2021-01-23,7,2021,"3",2913314,675,96,578,97,579,3.29521637557778,3.32954154615671,0.167820069204152
"United States","Kansas","KS",2021-01-24,2021-01-30,7,2021,"4",2913314,696,181,571,125,515,6.21285587478727,4.2906463223669,0.218914185639229
"United States","Kansas","KS",2021-01-31,2021-02-06,7,2021,"5",2913314,688,322,579,109,366,11.0527049264171,3.74144359310394,0.18825561312608
"United States","Kansas","KS",2021-02-07,2021-02-13,7,2021,"6",2913314,588,263,577,11,325,9.02751986225996,0.377576876368287,0.0190641247833623
"United States","Kansas","KS",2021-02-14,2021-02-20,7,2021,"7",2913314,593,266,572,21,327,9.13049537399676,0.720828582157639,0.0367132867132867
"United States","Kansas","KS",2021-02-21,2021-02-27,7,2021,"8",2913314,600,122,574,26,478,4.18767081063009,0.892454435052315,0.0452961672473868
"United States","Kansas","KS",2021-02-28,2021-03-06,7,2021,"9",2913314,557,94,577,-20,463,3.22656603441991,-0.686503411578704,-0.0346620450606586
"United States","Kansas","KS",2021-03-07,2021-03-13,7,2021,"10",2913314,533,52,569,-36,481,1.78490887010463,-1.23570614084167,-0.0632688927943761
"United States","Kansas","KS",2021-03-14,2021-03-20,7,2021,"11",2913314,510,15,558,-48,495,0.514877558684028,-1.64760818778889,-0.0860215053763441
"United States","Kansas","KS",2021-03-21,2021-03-27,7,2021,"12",2913314,526,-21,543,-17,547,-0.720828582157639,-0.583527899841898,-0.0313075506445673
"United States","Kansas","KS",2021-03-28,2021-04-03,7,2021,"13",2913314,526,41,536,-10,485,1.40733199373634,-0.343251705789352,-0.0186567164179104
"United States","Kansas","KS",2021-04-04,2021-04-10,7,2021,"14",2913314,512,5,526,-14,507,0.171625852894676,-0.480552388105093,-0.0266159695817491
"United States","Kansas","KS",2021-04-11,2021-04-17,7,2021,"15",2913314,500,18,520,-20,482,0.617853070420833,-0.686503411578704,-0.0384615384615384
"United States","Kansas","KS",2021-04-18,2021-04-24,7,2021,"16",2913314,534,12,513,21,522,0.411902046947222,0.720828582157639,0.0409356725146199
"United States","Kansas","KS",2021-04-25,2021-05-01,7,2021,"17",2913314,519,14,511,8,505,0.480552388105093,0.274601364631482,0.0156555772994129
"United States","Kansas","KS",2021-05-02,2021-05-08,7,2021,"18",2913314,519,34,503,16,485,1.1670557996838,0.549202729262963,0.0318091451292246
"United States","Kansas","KS",2021-05-09,2021-05-15,7,2021,"19",2913314,516,22,502,14,494,0.755153752736574,0.480552388105093,0.0278884462151394
"United States","Kansas","KS",2021-05-16,2021-05-22,7,2021,"20",2913314,562,19,501,61,543,0.652178240999769,2.09383540531505,0.121756487025948
"United States","Kansas","KS",2021-05-23,2021-05-29,7,2021,"21",2913314,486,19,499,-13,467,0.652178240999769,-0.446227217526157,-0.0260521042084169
"United States","Kansas","KS",2021-05-30,2021-06-05,7,2021,"22",2913314,525,8,499,26,517,0.274601364631482,0.892454435052315,0.0521042084168337
"United States","Kansas","KS",2021-06-06,2021-06-12,7,2021,"23",2913314,545,22,502,43,523,0.755153752736574,1.47598233489421,0.0856573705179282
"United States","Kansas","KS",2021-06-13,2021-06-19,7,2021,"24",2913314,509,23,504,5,486,0.78947892331551,0.171625852894676,0.00992063492063489
"United States","Kansas","KS",2021-06-20,2021-06-26,7,2021,"25",2913314,509,18,498,11,491,0.617853070420833,0.377576876368287,0.0220883534136547
"United States","Kansas","KS",2021-06-27,2021-07-03,7,2021,"26",2913314,528,12,495,33,516,0.411902046947222,1.13273062910486,0.0666666666666667
"United States","Kansas","KS",2021-07-04,2021-07-10,7,2021,"27",2913314,506,17,498,8,489,0.583527899841898,0.274601364631482,0.0160642570281124
"United States","Kentucky","KY",2019-12-29,2020-01-04,7,2020,"1",4467673,1093,0,1052,41,1093,0,0.917703690489434,0.0389733840304183
"United States","Kentucky","KY",2020-01-05,2020-01-11,7,2020,"2",4467673,1058,0,1054,4,1058,0,0.0895320673648228,0.00379506641366234
"United States","Kentucky","KY",2020-01-12,2020-01-18,7,2020,"3",4467673,1041,0,1039,2,1041,0,0.0447660336824114,0.00192492781520692
"United States","Kentucky","KY",2020-01-19,2020-01-25,7,2020,"4",4467673,944,0,1024,-80,944,0,-1.79064134729646,-0.078125
"United States","Kentucky","KY",2020-01-26,2020-02-01,7,2020,"5",4467673,978,0,1011,-33,978,0,-0.738639555759788,-0.0326409495548962
"United States","Kentucky","KY",2020-02-02,2020-02-08,7,2020,"6",4467673,956,0,992,-36,956,0,-0.805788606283405,-0.0362903225806451
"United States","Kentucky","KY",2020-02-09,2020-02-15,7,2020,"7",4467673,955,0,996,-41,955,0,-0.917703690489434,-0.0411646586345381
"United States","Kentucky","KY",2020-02-16,2020-02-22,7,2020,"8",4467673,992,0,988,4,992,0,0.0895320673648228,0.00404858299595134
"United States","Kentucky","KY",2020-02-23,2020-02-29,7,2020,"9",4467673,1022,0,971,51,1022,0,1.14153385890149,0.0525231719876416
"United States","Kentucky","KY",2020-03-01,2020-03-07,7,2020,"10",4467673,1006,0,971,35,1006,0,0.7834055894422,0.0360453141091659
"United States","Kentucky","KY",2020-03-08,2020-03-14,7,2020,"11",4467673,1021,0,970,51,1021,0,1.14153385890149,0.0525773195876289
"United States","Kentucky","KY",2020-03-15,2020-03-21,7,2020,"12",4467673,949,3,958,-9,946,0.0671490505236171,-0.201447151570851,-0.00939457202505223
"United States","Kentucky","KY",2020-03-22,2020-03-28,7,2020,"13",4467673,937,7,950,-13,930,0.15668111788844,-0.290979218935674,-0.0136842105263157
"United States","Kentucky","KY",2020-03-29,2020-04-04,7,2020,"14",4467673,1048,30,945,103,1018,0.671490505236171,2.30545073464419,0.108994708994709
"United States","Kentucky","KY",2020-04-05,2020-04-11,7,2020,"15",4467673,1026,54,944,82,972,1.20868290942511,1.83540738097887,0.0868644067796611
"United States","Kentucky","KY",2020-04-12,2020-04-18,7,2020,"16",4467673,960,50,938,22,910,1.11915084206029,0.492426370506525,0.023454157782516
"United States","Kentucky","KY",2020-04-19,2020-04-25,7,2020,"17",4467673,975,61,926,49,914,1.36536402731355,1.09676782521908,0.0529157667386608
"United States","Kentucky","KY",2020-04-26,2020-05-02,7,2020,"18",4467673,998,43,914,84,955,0.962469724171845,1.88017341466128,0.0919037199124726
"United States","Kentucky","KY",2020-05-03,2020-05-09,7,2020,"19",4467673,1006,56,898,108,950,1.25344894310752,2.41736581885022,0.120267260579065
"United States","Kentucky","KY",2020-05-10,2020-05-16,7,2020,"20",4467673,995,30,884,111,965,0.671490505236171,2.48451486937383,0.125565610859729
"United States","Kentucky","KY",2020-05-17,2020-05-23,7,2020,"21",4467673,998,57,879,119,941,1.27583195994872,2.66357900410348,0.135381114903299
"United States","Kentucky","KY",2020-05-24,2020-05-30,7,2020,"22",4467673,987,40,885,102,947,0.895320673648228,2.28306771780298,0.115254237288136
"United States","Kentucky","KY",2020-05-31,2020-06-06,7,2020,"23",4467673,918,38,877,41,880,0.850554639965817,0.917703690489434,0.0467502850627137
"United States","Kentucky","KY",2020-06-07,2020-06-13,7,2020,"24",4467673,1002,29,878,124,973,0.649107488394965,2.77549408830951,0.14123006833713
"United States","Kentucky","KY",2020-06-14,2020-06-20,7,2020,"25",4467673,966,26,881,85,940,0.581958437871348,1.90255643150248,0.0964812712826333
"United States","Kentucky","KY",2020-06-21,2020-06-27,7,2020,"26",4467673,937,30,880,57,907,0.671490505236171,1.27583195994872,0.0647727272727272
"United States","Kentucky","KY",2020-06-28,2020-07-04,7,2020,"27",4467673,993,31,874,119,962,0.693873522077377,2.66357900410348,0.136155606407323
"United States","Kentucky","KY",2020-07-05,2020-07-11,7,2020,"28",4467673,1047,37,863,184,1010,0.828171623124611,4.11847509878185,0.213209733487833
"United States","Kentucky","KY",2020-07-12,2020-07-18,7,2020,"29",4467673,936,45,866,70,891,1.00723575785426,1.5668111788844,0.0808314087759816
"United States","Kentucky","KY",2020-07-19,2020-07-25,7,2020,"30",4467673,968,29,859,109,939,0.649107488394965,2.43974883569142,0.126891734575087
"United States","Kentucky","KY",2020-07-26,2020-08-01,7,2020,"31",4467673,1031,44,856,175,987,0.984852741013051,3.917027947211,0.204439252336449
"United States","Kentucky","KY",2020-08-02,2020-08-08,7,2020,"32",4467673,1007,32,854,153,975,0.716256538918582,3.42460157670447,0.179156908665105
"United States","Kentucky","KY",2020-08-09,2020-08-15,7,2020,"33",4467673,1015,38,857,158,977,0.850554639965817,3.5365166609105,0.18436406067678
"United States","Kentucky","KY",2020-08-16,2020-08-22,7,2020,"34",4467673,1078,62,858,220,1016,1.38774704415475,4.92426370506525,0.256410256410256
"United States","Kentucky","KY",2020-08-23,2020-08-29,7,2020,"35",4467673,1007,49,853,154,958,1.09676782521908,3.44698459354568,0.180539273153576
"United States","Kentucky","KY",2020-08-30,2020-09-05,7,2020,"36",4467673,1055,72,862,193,983,1.61157721256681,4.3199222503527,0.223897911832947
"United States","Kentucky","KY",2020-09-06,2020-09-12,7,2020,"37",4467673,1020,64,862,158,956,1.43251307783716,3.5365166609105,0.183294663573086
"United States","Kentucky","KY",2020-09-13,2020-09-19,7,2020,"38",4467673,1017,51,868,149,966,1.14153385890149,3.33506950933965,0.171658986175115
"United States","Kentucky","KY",2020-09-20,2020-09-26,7,2020,"39",4467673,1069,46,871,198,1023,1.02961877469546,4.43183733455873,0.227324913892078
"United States","Kentucky","KY",2020-09-27,2020-10-03,7,2020,"40",4467673,1008,51,887,121,957,1.14153385890149,2.70834503778589,0.13641488162345
"United States","Kentucky","KY",2020-10-04,2020-10-10,7,2020,"41",4467673,1068,44,884,184,1024,0.984852741013051,4.11847509878185,0.20814479638009
"United States","Kentucky","KY",2020-10-11,2020-10-17,7,2020,"42",4467673,1127,63,892,235,1064,1.41013006099596,5.26000895768334,0.263452914798206
"United States","Kentucky","KY",2020-10-18,2020-10-24,7,2020,"43",4467673,1183,92,900,283,1091,2.05923754939092,6.33439376606121,0.314444444444445
"United States","Kentucky","KY",2020-10-25,2020-10-31,7,2020,"44",4467673,1125,79,910,215,1046,1.76825833045525,4.81234862085923,0.236263736263736
"United States","Kentucky","KY",2020-11-01,2020-11-07,7,2020,"45",4467673,1181,76,923,258,1105,1.70110927993163,5.77481834503107,0.279523293607801
"United States","Kentucky","KY",2020-11-08,2020-11-14,7,2020,"46",4467673,1187,98,926,261,1089,2.19353565043816,5.84196739555469,0.281857451403888
"United States","Kentucky","KY",2020-11-15,2020-11-21,7,2020,"47",4467673,1289,125,930,359,1164,2.79787710515071,8.03550304599285,0.386021505376344
"United States","Kentucky","KY",2020-11-22,2020-11-28,7,2020,"48",4467673,1332,102,942,390,1230,2.28306771780298,8.72937656807022,0.414012738853503
"United States","Kentucky","KY",2020-11-29,2020-12-05,7,2020,"49",4467673,1357,178,958,399,1179,3.98417699773462,8.93082371964108,0.416492693110647
"United States","Kentucky","KY",2020-12-06,2020-12-12,7,2020,"50",4467673,1410,130,962,448,1280,2.90979218935674,10.0275915448602,0.465696465696466
"United States","Kentucky","KY",2020-12-13,2020-12-19,7,2020,"51",4467673,1382,179,987,395,1203,4.00656001457582,8.84129165227625,0.400202634245187
"United States","Kentucky","KY",2020-12-20,2020-12-26,7,2020,"52",4467673,1485,163,1011,474,1322,3.64843174511653,10.6095499827315,0.468842729970326
"United States","Kentucky","KY",2020-12-27,2021-01-02,7,2020,"53",4467673,1409,164,1020,389,1245,3.67081476195774,8.70699355122902,0.381372549019608
"United States","Kentucky","KY",2021-01-03,2021-01-09,7,2021,"1",4467673,1292,178,1033,259,1114,3.98417699773462,5.79720136187228,0.250726040658277
"United States","Kentucky","KY",2021-01-10,2021-01-16,7,2021,"2",4467673,1398,216,1035,363,1182,4.83473163770043,8.12503511335767,0.350724637681159
"United States","Kentucky","KY",2021-01-17,2021-01-23,7,2021,"3",4467673,1319,294,1034,285,1025,6.58060695131448,6.37915979974362,0.275628626692457
"United States","Kentucky","KY",2021-01-24,2021-01-30,7,2021,"4",4467673,1266,328,1024,242,938,7.34162952391547,5.41669007557178,0.236328125
"United States","Kentucky","KY",2021-01-31,2021-02-06,7,2021,"5",4467673,1177,306,1024,153,871,6.84920315340894,3.42460157670447,0.1494140625
"United States","Kentucky","KY",2021-02-07,2021-02-13,7,2021,"6",4467673,1172,252,1018,154,920,5.64052024398384,3.44698459354568,0.151277013752456
"United States","Kentucky","KY",2021-02-14,2021-02-20,7,2021,"7",4467673,1146,154,1017,129,992,3.44698459354568,2.88740917251554,0.126843657817109
"United States","Kentucky","KY",2021-02-21,2021-02-27,7,2021,"8",4467673,1118,199,1007,111,919,4.45422035139994,2.48451486937383,0.110228401191658
"United States","Kentucky","KY",2021-02-28,2021-03-06,7,2021,"9",4467673,1076,181,1004,72,895,4.05132604825823,1.61157721256681,0.0717131474103585
"United States","Kentucky","KY",2021-03-07,2021-03-13,7,2021,"10",4467673,1139,160,998,141,979,3.58128269459291,3.15600537461,0.14128256513026
"United States","Kentucky","KY",2021-03-14,2021-03-20,7,2021,"11",4467673,1026,754,989,37,272,16.8767946982691,0.828171623124611,0.0374115267947421
"United States","Kentucky","KY",2021-03-21,2021-03-27,7,2021,"12",4467673,1036,290,975,61,746,6.49107488394965,1.36536402731355,0.0625641025641026
"United States","Kentucky","KY",2021-03-28,2021-04-03,7,2021,"13",4467673,988,139,976,12,849,3.11123934092759,0.268596202094468,0.0122950819672132
"United States","Kentucky","KY",2021-04-04,2021-04-10,7,2021,"14",4467673,1067,92,965,102,975,2.05923754939092,2.28306771780298,0.105699481865285
"United States","Kentucky","KY",2021-04-11,2021-04-17,7,2021,"15",4467673,1042,89,959,83,953,1.99208849886731,1.85779039782007,0.086548488008342
"United States","Kentucky","KY",2021-04-18,2021-04-24,7,2021,"16",4467673,1035,106,956,79,929,2.3725997851678,1.76825833045525,0.0826359832635983
"United States","Kentucky","KY",2021-04-25,2021-05-01,7,2021,"17",4467673,1014,77,948,66,937,1.72349229677284,1.47727911151958,0.0696202531645569
"United States","Kentucky","KY",2021-05-02,2021-05-08,7,2021,"18",4467673,980,65,938,42,915,1.45489609467837,0.940086707330639,0.044776119402985
"United States","Kentucky","KY",2021-05-09,2021-05-15,7,2021,"19",4467673,942,70,931,11,872,1.5668111788844,0.246213185253263,0.0118152524167561
"United States","Kentucky","KY",2021-05-16,2021-05-22,7,2021,"20",4467673,1045,57,916,129,988,1.27583195994872,2.88740917251554,0.140829694323144
"United States","Kentucky","KY",2021-05-23,2021-05-29,7,2021,"21",4467673,1038,77,913,125,961,1.72349229677284,2.79787710515071,0.136911281489595
"United States","Kentucky","KY",2021-05-30,2021-06-05,7,2021,"22",4467673,941,309,913,28,632,6.91635220393256,0.62672447155376,0.0306681270536693
"United States","Kentucky","KY",2021-06-06,2021-06-12,7,2021,"23",4467673,955,64,912,43,891,1.43251307783716,0.962469724171845,0.0471491228070176
"United States","Kentucky","KY",2021-06-13,2021-06-19,7,2021,"24",4467673,985,25,916,69,960,0.559575421030143,1.54442816204319,0.0753275109170306
"United States","Kentucky","KY",2021-06-20,2021-06-26,7,2021,"25",4467673,929,24,920,9,905,0.537192404188937,0.201447151570851,0.00978260869565228
"United States","Kentucky","KY",2021-06-27,2021-07-03,7,2021,"26",4467673,886,25,907,-21,861,0.559575421030143,-0.47004335366532,-0.0231532524807057
"United States","Kentucky","KY",2021-07-04,2021-07-10,7,2021,"27",4467673,805,26,898,-93,779,0.581958437871348,-2.08162056623213,-0.103563474387528
"United States","Louisiana","LA",2019-12-29,2020-01-04,7,2020,"1",4648794,927,0,997,-70,927,0,-1.50576687201025,-0.0702106318956871
"United States","Louisiana","LA",2020-01-05,2020-01-11,7,2020,"2",4648794,967,0,992,-25,967,0,-0.537773882860802,-0.0252016129032258
"United States","Louisiana","LA",2020-01-12,2020-01-18,7,2020,"3",4648794,960,0,987,-27,960,0,-0.580795793489666,-0.0273556231003039
"United States","Louisiana","LA",2020-01-19,2020-01-25,7,2020,"4",4648794,970,0,999,-29,970,0,-0.623817704118531,-0.029029029029029
"United States","Louisiana","LA",2020-01-26,2020-02-01,7,2020,"5",4648794,977,0,991,-14,977,0,-0.301153374402049,-0.0141271442986882
"United States","Louisiana","LA",2020-02-02,2020-02-08,7,2020,"6",4648794,956,0,996,-40,956,0,-0.860438212577283,-0.0401606425702812
"United States","Louisiana","LA",2020-02-09,2020-02-15,7,2020,"7",4648794,951,0,976,-25,951,0,-0.537773882860802,-0.0256147540983607
"United States","Louisiana","LA",2020-02-16,2020-02-22,7,2020,"8",4648794,950,0,955,-5,950,0,-0.10755477657216,-0.00523560209424079
"United States","Louisiana","LA",2020-02-23,2020-02-29,7,2020,"9",4648794,993,0,940,53,993,0,1.1400806316649,0.0563829787234043
"United States","Louisiana","LA",2020-03-01,2020-03-07,7,2020,"10",4648794,964,0,930,34,964,0,0.731372480690691,0.0365591397849463
"United States","Louisiana","LA",2020-03-08,2020-03-14,7,2020,"11",4648794,994,1,937,57,993,0.0215109553144321,1.22612445292263,0.0608324439701173
"United States","Louisiana","LA",2020-03-15,2020-03-21,7,2020,"12",4648794,955,19,944,11,936,0.40870815097421,0.236620508458753,0.0116525423728813
"United States","Louisiana","LA",2020-03-22,2020-03-28,7,2020,"13",4648794,1233,117,936,297,1116,2.51678177178855,6.38875372838633,0.317307692307692
"United States","Louisiana","LA",2020-03-29,2020-04-04,7,2020,"14",4648794,1390,271,925,465,1119,5.8294688902111,10.0025942212109,0.502702702702703
"United States","Louisiana","LA",2020-04-05,2020-04-11,7,2020,"15",4648794,1529,395,923,606,1134,8.49682734920067,13.0356389205458,0.656554712892741
"United States","Louisiana","LA",2020-04-12,2020-04-18,7,2020,"16",4648794,1360,465,927,433,895,10.0025942212109,9.31424365114909,0.467098166127292
"United States","Louisiana","LA",2020-04-19,2020-04-25,7,2020,"17",4648794,1248,375,913,335,873,8.06660824291203,7.20617003033475,0.366922234392114
"United States","Louisiana","LA",2020-04-26,2020-05-02,7,2020,"18",4648794,1171,302,902,269,869,6.49630850495849,5.78644697958223,0.298226164079823
"United States","Louisiana","LA",2020-05-03,2020-05-09,7,2020,"19",4648794,1129,241,899,230,888,5.18414023077813,4.94751972231938,0.255839822024472
"United States","Louisiana","LA",2020-05-10,2020-05-16,7,2020,"20",4648794,1105,225,891,214,880,4.83996494574722,4.60334443728847,0.240179573512907
"United States","Louisiana","LA",2020-05-17,2020-05-23,7,2020,"21",4648794,1052,149,890,162,903,3.20513234185038,3.484774760938,0.182022471910112
"United States","Louisiana","LA",2020-05-24,2020-05-30,7,2020,"22",4648794,1054,118,886,168,936,2.53829272710299,3.61384049282459,0.18961625282167
"United States","Louisiana","LA",2020-05-31,2020-06-06,7,2020,"23",4648794,1016,134,870,146,882,2.8824680121339,3.14059947590708,0.167816091954023
"United States","Louisiana","LA",2020-06-07,2020-06-13,7,2020,"24",4648794,951,78,853,98,873,1.6778545145257,2.10807362081434,0.114888628370457
"United States","Louisiana","LA",2020-06-14,2020-06-20,7,2020,"25",4648794,1004,99,855,149,905,2.12958457612878,3.20513234185038,0.174269005847953
"United States","Louisiana","LA",2020-06-21,2020-06-27,7,2020,"26",4648794,998,88,854,144,910,1.89296406767002,3.09757756527822,0.168618266978923
"United States","Louisiana","LA",2020-06-28,2020-07-04,7,2020,"27",4648794,985,92,849,136,893,1.97900788892775,2.92548992276276,0.160188457008245
"United States","Louisiana","LA",2020-07-05,2020-07-11,7,2020,"28",4648794,1061,126,855,206,935,2.71038036961844,4.43125679477301,0.24093567251462
"United States","Louisiana","LA",2020-07-12,2020-07-18,7,2020,"29",4648794,1152,104,853,299,1048,2.23713935270094,6.43177563901519,0.35052754982415
"United States","Louisiana","LA",2020-07-19,2020-07-25,7,2020,"30",4648794,1213,204,852,361,1009,4.38823488414415,7.76545486850998,0.423708920187793
"United States","Louisiana","LA",2020-07-26,2020-08-01,7,2020,"31",4648794,1205,232,849,356,973,4.99054163294824,7.65790009193782,0.419316843345112
"United States","Louisiana","LA",2020-08-02,2020-08-08,7,2020,"32",4648794,1243,254,859,384,989,5.46378264986575,8.26020684074192,0.447031431897555
"United States","Louisiana","LA",2020-08-09,2020-08-15,7,2020,"33",4648794,1181,218,855,326,963,4.6893882585462,7.01257143250486,0.381286549707602
"United States","Louisiana","LA",2020-08-16,2020-08-22,7,2020,"34",4648794,1132,239,848,284,893,5.14111832014927,6.10911130929871,0.334905660377359
"United States","Louisiana","LA",2020-08-23,2020-08-29,7,2020,"35",4648794,1098,195,849,249,903,4.19463628631426,5.35622787329359,0.293286219081272
"United States","Louisiana","LA",2020-08-30,2020-09-05,7,2020,"36",4648794,1110,131,864,246,979,2.8179351461906,5.29169500735029,0.284722222222222
"United States","Louisiana","LA",2020-09-06,2020-09-12,7,2020,"37",4648794,1027,160,860,167,867,3.44175285030913,3.59232953751016,0.194186046511628
"United States","Louisiana","LA",2020-09-13,2020-09-19,7,2020,"38",4648794,1040,140,859,181,900,3.01153374402049,3.89348291191221,0.210710128055879
"United States","Louisiana","LA",2020-09-20,2020-09-26,7,2020,"39",4648794,991,90,867,124,901,1.93598597829889,2.66735845898958,0.143021914648212
"United States","Louisiana","LA",2020-09-27,2020-10-03,7,2020,"40",4648794,1036,125,866,170,911,2.68886941430401,3.65686240345345,0.196304849884527
"United States","Louisiana","LA",2020-10-04,2020-10-10,7,2020,"41",4648794,1044,55,861,183,989,1.18310254229376,3.93650482254107,0.212543554006969
"United States","Louisiana","LA",2020-10-11,2020-10-17,7,2020,"42",4648794,991,85,867,124,906,1.82843120172673,2.66735845898958,0.143021914648212
"United States","Louisiana","LA",2020-10-18,2020-10-24,7,2020,"43",4648794,1008,87,882,126,921,1.87145311235559,2.71038036961844,0.142857142857143
"United States","Louisiana","LA",2020-10-25,2020-10-31,7,2020,"44",4648794,951,91,891,60,860,1.95749693361332,1.29065731886593,0.0673400673400673
"United States","Louisiana","LA",2020-11-01,2020-11-07,7,2020,"45",4648794,1052,82,900,152,970,1.76389833578343,3.26966520779368,0.168888888888889
"United States","Louisiana","LA",2020-11-08,2020-11-14,7,2020,"46",4648794,1056,98,903,153,958,2.10807362081434,3.29117616310811,0.169435215946844
"United States","Louisiana","LA",2020-11-15,2020-11-21,7,2020,"47",4648794,1068,348,924,144,720,7.48581244942237,3.09757756527822,0.155844155844156
"United States","Louisiana","LA",2020-11-22,2020-11-28,7,2020,"48",4648794,1084,174,930,154,910,3.74290622471118,3.31268711842254,0.165591397849462
"United States","Louisiana","LA",2020-11-29,2020-12-05,7,2020,"49",4648794,1103,139,934,169,964,2.99002278870606,3.63535144813902,0.180942184154176
"United States","Louisiana","LA",2020-12-06,2020-12-12,7,2020,"50",4648794,1238,220,943,295,1018,4.73241016917506,6.34573181775747,0.312831389183457
"United States","Louisiana","LA",2020-12-13,2020-12-19,7,2020,"51",4648794,1207,228,938,269,979,4.90449781169052,5.78644697958223,0.286780383795309
"United States","Louisiana","LA",2020-12-20,2020-12-26,7,2020,"52",4648794,1240,278,932,308,962,5.98004557741212,6.62537423684508,0.330472103004292
"United States","Louisiana","LA",2020-12-27,2021-01-02,7,2020,"53",4648794,1251,214,950,301,1037,4.60334443728847,6.47479754964406,0.316842105263158
"United States","Louisiana","LA",2021-01-03,2021-01-09,7,2021,"1",4648794,1395,347,952,443,1048,7.46430149410793,9.52935320429341,0.465336134453781
"United States","Louisiana","LA",2021-01-10,2021-01-16,7,2021,"2",4648794,1403,247,952,451,1156,5.31320596266473,9.70144084680887,0.473739495798319
"United States","Louisiana","LA",2021-01-17,2021-01-23,7,2021,"3",4648794,1359,403,954,405,956,8.66891499171613,8.711936902345,0.424528301886792
"United States","Louisiana","LA",2021-01-24,2021-01-30,7,2021,"4",4648794,1257,318,957,300,939,6.8404837899894,6.45328659432963,0.313479623824451
"United States","Louisiana","LA",2021-01-31,2021-02-06,7,2021,"5",4648794,1201,275,949,252,926,5.91551271146882,5.42076073923689,0.265542676501581
"United States","Louisiana","LA",2021-02-07,2021-02-13,7,2021,"6",4648794,1168,200,937,231,968,4.30219106288642,4.96903067763381,0.246531483457844
"United States","Louisiana","LA",2021-02-14,2021-02-20,7,2021,"7",4648794,1167,165,913,254,1002,3.54930762688129,5.46378264986575,0.278203723986856
"United States","Louisiana","LA",2021-02-21,2021-02-27,7,2021,"8",4648794,1107,148,892,215,959,3.18362138653595,4.6248553926029,0.241031390134529
"United States","Louisiana","LA",2021-02-28,2021-03-06,7,2021,"9",4648794,1081,127,885,196,954,2.73189132493288,4.21614724162869,0.221468926553672
"United States","Louisiana","LA",2021-03-07,2021-03-13,7,2021,"10",4648794,1050,145,882,168,905,3.11908852059265,3.61384049282459,0.19047619047619
"United States","Louisiana","LA",2021-03-14,2021-03-20,7,2021,"11",4648794,1006,127,873,133,879,2.73189132493288,2.86095705681947,0.152348224513173
"United States","Louisiana","LA",2021-03-21,2021-03-27,7,2021,"12",4648794,1025,100,884,141,925,2.15109553144321,3.03304469933492,0.159502262443439
"United States","Louisiana","LA",2021-03-28,2021-04-03,7,2021,"13",4648794,989,75,877,112,914,1.61332164858241,2.40922699521639,0.127708095781072
"United States","Louisiana","LA",2021-04-04,2021-04-10,7,2021,"14",4648794,967,53,868,99,914,1.1400806316649,2.12958457612878,0.114055299539171
"United States","Louisiana","LA",2021-04-11,2021-04-17,7,2021,"15",4648794,975,66,874,101,909,1.41972305075252,2.17260648675764,0.115560640732265
"United States","Louisiana","LA",2021-04-18,2021-04-24,7,2021,"16",4648794,997,54,864,133,943,1.16159158697933,2.86095705681947,0.153935185185185
"United States","Louisiana","LA",2021-04-25,2021-05-01,7,2021,"17",4648794,974,46,857,117,928,0.989503944463876,2.51678177178855,0.136522753792299
"United States","Louisiana","LA",2021-05-02,2021-05-08,7,2021,"18",4648794,906,51,866,40,855,1.09705872103604,0.860438212577283,0.046189376443418
"United States","Louisiana","LA",2021-05-09,2021-05-15,7,2021,"19",4648794,904,45,861,43,859,0.967992989149444,0.92497107852058,0.0499419279907085
"United States","Louisiana","LA",2021-05-16,2021-05-22,7,2021,"20",4648794,896,44,864,32,852,0.946482033835012,0.688350570061827,0.037037037037037
"United States","Louisiana","LA",2021-05-23,2021-05-29,7,2021,"21",4648794,897,54,858,39,843,1.16159158697933,0.838927257262851,0.0454545454545454
"United States","Louisiana","LA",2021-05-30,2021-06-05,7,2021,"22",4648794,930,39,853,77,891,0.838927257262851,1.65634355921127,0.0902696365767879
"United States","Louisiana","LA",2021-06-06,2021-06-12,7,2021,"23",4648794,904,33,857,47,871,0.709861525376259,1.01101489977831,0.0548424737456243
"United States","Louisiana","LA",2021-06-13,2021-06-19,7,2021,"24",4648794,906,40,845,61,866,0.860438212577283,1.31216827418036,0.0721893491124261
"United States","Louisiana","LA",2021-06-20,2021-06-26,7,2021,"25",4648794,907,35,838,69,872,0.752883436005123,1.48425591669581,0.0823389021479715
"United States","Louisiana","LA",2021-06-27,2021-07-03,7,2021,"26",4648794,752,34,829,-77,718,0.731372480690691,-1.65634355921127,-0.0928829915560917
"United States","Louisiana","LA",2021-07-04,2021-07-10,7,2021,"27",4648794,675,24,825,-150,651,0.51626292754637,-3.22664329716481,-0.181818181818182
"United States","Maine","ME",2019-12-29,2020-01-04,7,2020,"1",1344212,320,0,298,22,320,0,1.63664660038744,0.0738255033557047
"United States","Maine","ME",2020-01-05,2020-01-11,7,2020,"2",1344212,318,0,298,20,318,0,1.48786054580676,0.0671140939597314
"United States","Maine","ME",2020-01-12,2020-01-18,7,2020,"3",1344212,295,0,301,-6,295,0,-0.446358163742029,-0.0199335548172758
"United States","Maine","ME",2020-01-19,2020-01-25,7,2020,"4",1344212,308,0,299,9,308,0,0.669537245613043,0.0301003344481605
"United States","Maine","ME",2020-01-26,2020-02-01,7,2020,"5",1344212,288,0,296,-8,288,0,-0.595144218322705,-0.027027027027027
"United States","Maine","ME",2020-02-02,2020-02-08,7,2020,"6",1344212,316,0,295,21,316,0,1.5622535730971,0.0711864406779661
"United States","Maine","ME",2020-02-09,2020-02-15,7,2020,"7",1344212,329,0,291,38,329,0,2.82693503703285,0.130584192439863
"United States","Maine","ME",2020-02-16,2020-02-22,7,2020,"8",1344212,299,0,291,8,299,0,0.595144218322705,0.0274914089347078
"United States","Maine","ME",2020-02-23,2020-02-29,7,2020,"9",1344212,292,0,293,-1,292,0,-0.0743930272903381,-0.0034129692832765
"United States","Maine","ME",2020-03-01,2020-03-07,7,2020,"10",1344212,313,0,290,23,313,0,1.71103962767778,0.0793103448275863
"United States","Maine","ME",2020-03-08,2020-03-14,7,2020,"11",1344212,301,0,290,11,301,0,0.818323300193719,0.0379310344827586
"United States","Maine","ME",2020-03-15,2020-03-21,7,2020,"12",1344212,277,0,292,-15,277,0,-1.11589540935507,-0.0513698630136986
"United States","Maine","ME",2020-03-22,2020-03-28,7,2020,"13",1344212,279,1,301,-22,278,0.0743930272903381,-1.63664660038744,-0.0730897009966778
"United States","Maine","ME",2020-03-29,2020-04-04,7,2020,"14",1344212,300,9,296,4,291,0.669537245613043,0.297572109161353,0.0135135135135136
"United States","Maine","ME",2020-04-05,2020-04-11,7,2020,"15",1344212,304,9,292,12,295,0.669537245613043,0.892716327484057,0.0410958904109588
"United States","Maine","ME",2020-04-12,2020-04-18,7,2020,"16",1344212,310,13,289,21,297,0.967109354774396,1.5622535730971,0.0726643598615917
"United States","Maine","ME",2020-04-19,2020-04-25,7,2020,"17",1344212,285,18,284,1,267,1.33907449122609,0.0743930272903381,0.00352112676056349
"United States","Maine","ME",2020-04-26,2020-05-02,7,2020,"18",1344212,277,6,274,3,271,0.446358163742029,0.223179081871014,0.0109489051094891
"United States","Maine","ME",2020-05-03,2020-05-09,7,2020,"19",1344212,293,8,277,16,285,0.595144218322705,1.19028843664541,0.0577617328519855
"United States","Maine","ME",2020-05-10,2020-05-16,7,2020,"20",1344212,256,6,276,-20,250,0.446358163742029,-1.48786054580676,-0.072463768115942
"United States","Maine","ME",2020-05-17,2020-05-23,7,2020,"21",1344212,267,7,269,-2,260,0.520751191032367,-0.148786054580676,-0.00743494423791824
"United States","Maine","ME",2020-05-24,2020-05-30,7,2020,"22",1344212,302,12,268,34,290,0.892716327484057,2.5293629278715,0.126865671641791
"United States","Maine","ME",2020-05-31,2020-06-06,7,2020,"23",1344212,255,9,270,-15,246,0.669537245613043,-1.11589540935507,-0.0555555555555556
"United States","Maine","ME",2020-06-07,2020-06-13,7,2020,"24",1344212,254,2,269,-15,252,0.148786054580676,-1.11589540935507,-0.0557620817843866
"United States","Maine","ME",2020-06-14,2020-06-20,7,2020,"25",1344212,275,2,269,6,273,0.148786054580676,0.446358163742029,0.0223048327137547
"United States","Maine","ME",2020-06-21,2020-06-27,7,2020,"26",1344212,299,2,270,29,297,0.148786054580676,2.15739779141981,0.107407407407407
"United States","Maine","ME",2020-06-28,2020-07-04,7,2020,"27",1344212,280,5,272,8,275,0.371965136451691,0.595144218322705,0.0294117647058822
"United States","Maine","ME",2020-07-05,2020-07-11,7,2020,"28",1344212,289,5,273,16,284,0.371965136451691,1.19028843664541,0.0586080586080586
"United States","Maine","ME",2020-07-12,2020-07-18,7,2020,"29",1344212,294,3,267,27,291,0.223179081871014,2.00861173683913,0.101123595505618
"United States","Maine","ME",2020-07-19,2020-07-25,7,2020,"30",1344212,282,2,268,14,280,0.148786054580676,1.04150238206473,0.0522388059701493
"United States","Maine","ME",2020-07-26,2020-08-01,7,2020,"31",1344212,283,4,275,8,279,0.297572109161353,0.595144218322705,0.0290909090909091
"United States","Maine","ME",2020-08-02,2020-08-08,7,2020,"32",1344212,276,2,273,3,274,0.148786054580676,0.223179081871014,0.0109890109890109
"United States","Maine","ME",2020-08-09,2020-08-15,7,2020,"33",1344212,280,2,272,8,278,0.148786054580676,0.595144218322705,0.0294117647058822
"United States","Maine","ME",2020-08-16,2020-08-22,7,2020,"34",1344212,312,3,275,37,309,0.223179081871014,2.75254200974251,0.134545454545455
"United States","Maine","ME",2020-08-23,2020-08-29,7,2020,"35",1344212,285,2,271,14,283,0.148786054580676,1.04150238206473,0.051660516605166
"United States","Maine","ME",2020-08-30,2020-09-05,7,2020,"36",1344212,289,2,271,18,287,0.148786054580676,1.33907449122609,0.0664206642066421
"United States","Maine","ME",2020-09-06,2020-09-12,7,2020,"37",1344212,319,0,272,47,319,0,3.49647228264589,0.172794117647059
"United States","Maine","ME",2020-09-13,2020-09-19,7,2020,"38",1344212,299,5,279,20,294,0.371965136451691,1.48786054580676,0.0716845878136201
"United States","Maine","ME",2020-09-20,2020-09-26,7,2020,"39",1344212,309,1,282,27,308,0.0743930272903381,2.00861173683913,0.0957446808510638
"United States","Maine","ME",2020-09-27,2020-10-03,7,2020,"40",1344212,289,2,290,-1,287,0.148786054580676,-0.0743930272903381,-0.00344827586206897
"United States","Maine","ME",2020-10-04,2020-10-10,7,2020,"41",1344212,302,1,288,14,301,0.0743930272903381,1.04150238206473,0.0486111111111112
"United States","Maine","ME",2020-10-11,2020-10-17,7,2020,"42",1344212,275,3,287,-12,272,0.223179081871014,-0.892716327484057,-0.0418118466898955
"United States","Maine","ME",2020-10-18,2020-10-24,7,2020,"43",1344212,275,0,289,-14,275,0,-1.04150238206473,-0.0484429065743944
"United States","Maine","ME",2020-10-25,2020-10-31,7,2020,"44",1344212,275,1,288,-13,274,0.0743930272903381,-0.967109354774396,-0.0451388888888888
"United States","Maine","ME",2020-11-01,2020-11-07,7,2020,"45",1344212,334,5,289,45,329,0.371965136451691,3.34768622806522,0.155709342560554
"United States","Maine","ME",2020-11-08,2020-11-14,7,2020,"46",1344212,323,11,290,33,312,0.818323300193719,2.45496990058116,0.113793103448276
"United States","Maine","ME",2020-11-15,2020-11-21,7,2020,"47",1344212,307,13,301,6,294,0.967109354774396,0.446358163742029,0.0199335548172757
"United States","Maine","ME",2020-11-22,2020-11-28,7,2020,"48",1344212,349,15,301,48,334,1.11589540935507,3.57086530993623,0.159468438538206
"United States","Maine","ME",2020-11-29,2020-12-05,7,2020,"49",1344212,342,35,305,37,307,2.60375595516183,2.75254200974251,0.121311475409836
"United States","Maine","ME",2020-12-06,2020-12-12,7,2020,"50",1344212,353,31,305,48,322,2.30618384600048,3.57086530993623,0.157377049180328
"United States","Maine","ME",2020-12-13,2020-12-19,7,2020,"51",1344212,324,35,303,21,289,2.60375595516183,1.5622535730971,0.0693069306930694
"United States","Maine","ME",2020-12-20,2020-12-26,7,2020,"52",1344212,347,27,302,45,320,2.00861173683913,3.34768622806522,0.149006622516556
"United States","Maine","ME",2020-12-27,2021-01-02,7,2020,"53",1344212,355,116,305,50,239,8.62959116567922,3.71965136451691,0.163934426229508
"United States","Maine","ME",2021-01-03,2021-01-09,7,2021,"1",1344212,345,42,307,38,303,3.1245071461942,2.82693503703285,0.123778501628665
"United States","Maine","ME",2021-01-10,2021-01-16,7,2021,"2",1344212,362,62,306,56,300,4.61236769200096,4.16600952825894,0.183006535947712
"United States","Maine","ME",2021-01-17,2021-01-23,7,2021,"3",1344212,335,52,306,29,283,3.86843741909758,2.15739779141981,0.0947712418300655
"United States","Maine","ME",2021-01-24,2021-01-30,7,2021,"4",1344212,360,36,306,54,324,2.67814898245217,4.01722347367826,0.176470588235294
"United States","Maine","ME",2021-01-31,2021-02-06,7,2021,"5",1344212,305,8,305,0,297,0.595144218322705,0,0
"United States","Maine","ME",2021-02-07,2021-02-13,7,2021,"6",1344212,331,13,302,29,318,0.967109354774396,2.15739779141981,0.0960264900662251
"United States","Maine","ME",2021-02-14,2021-02-20,7,2021,"7",1344212,292,11,304,-12,281,0.818323300193719,-0.892716327484057,-0.0394736842105263
"United States","Maine","ME",2021-02-21,2021-02-27,7,2021,"8",1344212,283,44,303,-20,239,3.27329320077488,-1.48786054580676,-0.066006600660066
"United States","Maine","ME",2021-02-28,2021-03-06,7,2021,"9",1344212,331,4,308,23,327,0.297572109161353,1.71103962767778,0.0746753246753247
"United States","Maine","ME",2021-03-07,2021-03-13,7,2021,"10",1344212,287,17,307,-20,270,1.26468146393575,-1.48786054580676,-0.0651465798045603
"United States","Maine","ME",2021-03-14,2021-03-20,7,2021,"11",1344212,249,4,312,-63,245,0.297572109161353,-4.6867607192913,-0.201923076923077
"United States","Maine","ME",2021-03-21,2021-03-27,7,2021,"12",1344212,269,8,310,-41,261,0.595144218322705,-3.05011411890386,-0.132258064516129
"United States","Maine","ME",2021-03-28,2021-04-03,7,2021,"13",1344212,313,9,312,1,304,0.669537245613043,0.0743930272903381,0.00320512820512819
"United States","Maine","ME",2021-04-04,2021-04-10,7,2021,"14",1344212,289,5,305,-16,284,0.371965136451691,-1.19028843664541,-0.0524590163934426
"United States","Maine","ME",2021-04-11,2021-04-17,7,2021,"15",1344212,311,14,304,7,297,1.04150238206473,0.520751191032367,0.0230263157894737
"United States","Maine","ME",2021-04-18,2021-04-24,7,2021,"16",1344212,294,8,299,-5,286,0.595144218322705,-0.371965136451691,-0.0167224080267558
"United States","Maine","ME",2021-04-25,2021-05-01,7,2021,"17",1344212,307,17,289,18,290,1.26468146393575,1.33907449122609,0.0622837370242215
"United States","Maine","ME",2021-05-02,2021-05-08,7,2021,"18",1344212,299,6,284,15,293,0.446358163742029,1.11589540935507,0.0528169014084507
"United States","Maine","ME",2021-05-09,2021-05-15,7,2021,"19",1344212,297,6,282,15,291,0.446358163742029,1.11589540935507,0.053191489361702
"United States","Maine","ME",2021-05-16,2021-05-22,7,2021,"20",1344212,340,18,276,64,322,1.33907449122609,4.76115374658164,0.231884057971014
"United States","Maine","ME",2021-05-23,2021-05-29,7,2021,"21",1344212,316,6,274,42,310,0.446358163742029,3.1245071461942,0.153284671532847
"United States","Maine","ME",2021-05-30,2021-06-05,7,2021,"22",1344212,298,14,276,22,284,1.04150238206473,1.63664660038744,0.0797101449275361
"United States","Maine","ME",2021-06-06,2021-06-12,7,2021,"23",1344212,326,6,278,48,320,0.446358163742029,3.57086530993623,0.172661870503597
"United States","Maine","ME",2021-06-13,2021-06-19,7,2021,"24",1344212,297,9,280,17,288,0.669537245613043,1.26468146393575,0.0607142857142857
"United States","Maine","ME",2021-06-20,2021-06-26,7,2021,"25",1344212,321,4,277,44,317,0.297572109161353,3.27329320077488,0.15884476534296
"United States","Maine","ME",2021-06-27,2021-07-03,7,2021,"26",1344212,321,2,278,43,319,0.148786054580676,3.19890017348454,0.154676258992806
"United States","Maine","ME",2021-07-04,2021-07-10,7,2021,"27",1344212,324,2,281,43,322,0.148786054580676,3.19890017348454,0.153024911032029
"United States","Maryland","MD",2019-12-29,2020-01-04,7,2020,"1",6045680,1049,0,1091,-42,1049,0,-0.694710934088473,-0.0384967919340055
"United States","Maryland","MD",2020-01-05,2020-01-11,7,2020,"2",6045680,1035,0,1081,-46,1035,0,-0.760873880192137,-0.0425531914893617
"United States","Maryland","MD",2020-01-12,2020-01-18,7,2020,"3",6045680,988,0,1082,-94,988,0,-1.55482923343611,-0.0868761552680222
"United States","Maryland","MD",2020-01-19,2020-01-25,7,2020,"4",6045680,1003,0,1080,-77,1003,0,-1.27363671249553,-0.0712962962962963
"United States","Maryland","MD",2020-01-26,2020-02-01,7,2020,"5",6045680,1034,0,1081,-47,1034,0,-0.777414616718053,-0.0434782608695652
"United States","Maryland","MD",2020-02-02,2020-02-08,7,2020,"6",6045680,1004,0,1072,-68,1004,0,-1.12477008376229,-0.0634328358208955
"United States","Maryland","MD",2020-02-09,2020-02-15,7,2020,"7",6045680,1019,0,1062,-43,1019,0,-0.711251670614389,-0.0404896421845574
"United States","Maryland","MD",2020-02-16,2020-02-22,7,2020,"8",6045680,973,0,1052,-79,973,0,-1.30671818554737,-0.0750950570342205
"United States","Maryland","MD",2020-02-23,2020-02-29,7,2020,"9",6045680,1082,0,1042,40,1082,0,0.661629461036641,0.0383877159309021
"United States","Maryland","MD",2020-03-01,2020-03-07,7,2020,"10",6045680,1049,0,1021,28,1049,0,0.463140622725649,0.0274240940254653
"United States","Maryland","MD",2020-03-08,2020-03-14,7,2020,"11",6045680,1005,0,1000,5,1005,0,0.0827036826295801,0.00499999999999989
"United States","Maryland","MD",2020-03-15,2020-03-21,7,2020,"12",6045680,1064,3,991,73,1061,0.0496222095777481,1.20747376639187,0.0736629667003028
"United States","Maryland","MD",2020-03-22,2020-03-28,7,2020,"13",6045680,1092,7,990,102,1085,0.115785155681412,1.68715512564343,0.103030303030303
"United States","Maryland","MD",2020-03-29,2020-04-04,7,2020,"14",6045680,1191,43,980,211,1148,0.711251670614389,3.49009540696828,0.21530612244898
"United States","Maryland","MD",2020-04-05,2020-04-11,7,2020,"15",6045680,1353,149,978,375,1204,2.46456974236149,6.20277619721851,0.383435582822086
"United States","Maryland","MD",2020-04-12,2020-04-18,7,2020,"16",6045680,1357,172,963,394,1185,2.84500668245756,6.51705019121091,0.409138110072689
"United States","Maryland","MD",2020-04-19,2020-04-25,7,2020,"17",6045680,1538,321,952,586,1217,5.30957642481904,9.69287160418679,0.615546218487395
"United States","Maryland","MD",2020-04-26,2020-05-02,7,2020,"18",6045680,1523,397,931,592,1126,6.56667240078866,9.79211602334229,0.635875402792696
"United States","Maryland","MD",2020-05-03,2020-05-09,7,2020,"19",6045680,1445,337,918,527,1108,5.5742282092337,8.71696814915775,0.574074074074074
"United States","Maryland","MD",2020-05-10,2020-05-16,7,2020,"20",6045680,1431,343,918,513,1088,5.6734726283892,8.48539783779492,0.558823529411765
"United States","Maryland","MD",2020-05-17,2020-05-23,7,2020,"21",6045680,1336,315,922,414,1021,5.21033200566355,6.84786492172923,0.449023861171367
"United States","Maryland","MD",2020-05-24,2020-05-30,7,2020,"22",6045680,1265,320,919,346,945,5.29303568829313,5.72309483796695,0.376496191512514
"United States","Maryland","MD",2020-05-31,2020-06-06,7,2020,"23",6045680,1167,361,926,241,806,5.97120588585569,3.98631750274576,0.260259179265659
"United States","Maryland","MD",2020-06-07,2020-06-13,7,2020,"24",6045680,1158,184,925,233,974,3.04349552076855,3.85399161053843,0.251891891891892
"United States","Maryland","MD",2020-06-14,2020-06-20,7,2020,"25",6045680,1070,141,925,145,929,2.33224385015416,2.39840679625782,0.156756756756757
"United States","Maryland","MD",2020-06-21,2020-06-27,7,2020,"26",6045680,1031,108,923,108,923,1.78639954479893,1.78639954479893,0.117009750812568
"United States","Maryland","MD",2020-06-28,2020-07-04,7,2020,"27",6045680,1051,79,929,122,972,1.30671818554737,2.01796985616176,0.131324004305705
"United States","Maryland","MD",2020-07-05,2020-07-11,7,2020,"28",6045680,1031,79,923,108,952,1.30671818554737,1.78639954479893,0.117009750812568
"United States","Maryland","MD",2020-07-12,2020-07-18,7,2020,"29",6045680,1026,69,923,103,957,1.14131082028821,1.70369586216935,0.111592632719393
"United States","Maryland","MD",2020-07-19,2020-07-25,7,2020,"30",6045680,1002,63,913,89,939,1.04206640113271,1.47212555080653,0.0974808324205914
"United States","Maryland","MD",2020-07-26,2020-08-01,7,2020,"31",6045680,1067,66,911,156,1001,1.09168861071046,2.5803548980429,0.171240395170143
"United States","Maryland","MD",2020-08-02,2020-08-08,7,2020,"32",6045680,1007,69,901,106,938,1.14131082028821,1.7533180717471,0.117647058823529
"United States","Maryland","MD",2020-08-09,2020-08-15,7,2020,"33",6045680,1064,65,913,151,999,1.07514787418454,2.49765121541332,0.16538882803943
"United States","Maryland","MD",2020-08-16,2020-08-22,7,2020,"34",6045680,1002,48,907,95,954,0.793955353243969,1.57136996996202,0.104740904079383
"United States","Maryland","MD",2020-08-23,2020-08-29,7,2020,"35",6045680,1040,62,919,121,978,1.02552566460679,2.00142911963584,0.131664853101197
"United States","Maryland","MD",2020-08-30,2020-09-05,7,2020,"36",6045680,1046,53,928,118,993,0.876659035873549,1.95180691005809,0.127155172413793
"United States","Maryland","MD",2020-09-06,2020-09-12,7,2020,"37",6045680,996,38,910,86,958,0.628547987984809,1.42250334122878,0.0945054945054946
"United States","Maryland","MD",2020-09-13,2020-09-19,7,2020,"38",6045680,991,40,908,83,951,0.661629461036641,1.37288113165103,0.091409691629956
"United States","Maryland","MD",2020-09-20,2020-09-26,7,2020,"39",6045680,1071,49,923,148,1022,0.810496089769885,2.44802900583557,0.160346695557963
"United States","Maryland","MD",2020-09-27,2020-10-03,7,2020,"40",6045680,1074,31,932,142,1043,0.512762832303397,2.34878458668008,0.152360515021459
"United States","Maryland","MD",2020-10-04,2020-10-10,7,2020,"41",6045680,1086,34,940,146,1052,0.562385041881145,2.41494753278374,0.15531914893617
"United States","Maryland","MD",2020-10-11,2020-10-17,7,2020,"42",6045680,1052,49,962,90,1003,0.810496089769885,1.48866628733244,0.0935550935550935
"United States","Maryland","MD",2020-10-18,2020-10-24,7,2020,"43",6045680,1101,45,955,146,1056,0.744333143666221,2.41494753278374,0.152879581151832
"United States","Maryland","MD",2020-10-25,2020-10-31,7,2020,"44",6045680,1071,58,974,97,1013,0.959362718503129,1.60445144301385,0.0995893223819302
"United States","Maryland","MD",2020-11-01,2020-11-07,7,2020,"45",6045680,1088,56,979,109,1032,0.926281245451298,1.80294028132485,0.111338100102145
"United States","Maryland","MD",2020-11-08,2020-11-14,7,2020,"46",6045680,1106,80,985,121,1026,1.32325892207328,2.00142911963584,0.122842639593909
"United States","Maryland","MD",2020-11-15,2020-11-21,7,2020,"47",6045680,1224,130,989,235,1094,2.15029574836908,3.88707308359027,0.237613751263903
"United States","Maryland","MD",2020-11-22,2020-11-28,7,2020,"48",6045680,1185,161,1004,181,1024,2.66305858067248,2.9938733111908,0.180278884462151
"United States","Maryland","MD",2020-11-29,2020-12-05,7,2020,"49",6045680,1258,221,999,259,1037,3.65550277222744,4.28405076021225,0.259259259259259
"United States","Maryland","MD",2020-12-06,2020-12-12,7,2020,"50",6045680,1378,276,1025,353,1102,4.56524328115282,5.83887999364836,0.344390243902439
"United States","Maryland","MD",2020-12-13,2020-12-19,7,2020,"51",6045680,1432,305,1035,397,1127,5.04492464040439,6.56667240078866,0.383574879227053
"United States","Maryland","MD",2020-12-20,2020-12-26,7,2020,"52",6045680,1337,280,1044,293,1057,4.63140622725649,4.8464358020934,0.280651340996169
"United States","Maryland","MD",2020-12-27,2021-01-02,7,2020,"53",6045680,1477,275,1054,423,1202,4.54870254462691,6.99673155046248,0.401328273244782
"United States","Maryland","MD",2021-01-03,2021-01-09,7,2021,"1",6045680,1364,287,1062,302,1077,4.7471913829379,4.99530243082664,0.28436911487759
"United States","Maryland","MD",2021-01-10,2021-01-16,7,2021,"2",6045680,1426,271,1074,352,1155,4.48253959852324,5.82233925712244,0.327746741154562
"United States","Maryland","MD",2021-01-17,2021-01-23,7,2021,"3",6045680,1366,309,1074,292,1057,5.11108758650805,4.82989506556748,0.271880819366853
"United States","Maryland","MD",2021-01-24,2021-01-30,7,2021,"4",6045680,1330,286,1066,264,1044,4.73065064641198,4.36675444284183,0.24765478424015
"United States","Maryland","MD",2021-01-31,2021-02-06,7,2021,"5",6045680,1281,147,1065,216,1134,2.43148826930966,3.57279908959786,0.202816901408451
"United States","Maryland","MD",2021-02-07,2021-02-13,7,2021,"6",6045680,1304,202,1070,234,1102,3.34122877823504,3.87053234706435,0.218691588785047
"United States","Maryland","MD",2021-02-14,2021-02-20,7,2021,"7",6045680,1177,159,1056,121,1018,2.62997710762065,2.00142911963584,0.114583333333333
"United States","Maryland","MD",2021-02-21,2021-02-27,7,2021,"8",6045680,1184,164,1049,135,1020,2.71268079025023,2.23299943099866,0.128693994280267
"United States","Maryland","MD",2021-02-28,2021-03-06,7,2021,"9",6045680,1152,86,1051,101,1066,1.42250334122878,1.67061438911752,0.0960989533777354
"United States","Maryland","MD",2021-03-07,2021-03-13,7,2021,"10",6045680,1101,102,1047,54,999,1.68715512564343,0.893199772399465,0.0515759312320916
"United States","Maryland","MD",2021-03-14,2021-03-20,7,2021,"11",6045680,1150,122,1031,119,1028,2.01796985616176,1.96834764658401,0.115421920465567
"United States","Maryland","MD",2021-03-21,2021-03-27,7,2021,"12",6045680,1120,81,1027,93,1039,1.3397996585992,1.53828849691019,0.0905550146056475
"United States","Maryland","MD",2021-03-28,2021-04-03,7,2021,"13",6045680,1069,81,1024,45,988,1.3397996585992,0.744333143666221,0.0439453125
"United States","Maryland","MD",2021-04-04,2021-04-10,7,2021,"14",6045680,1165,103,1006,159,1062,1.70369586216935,2.62997710762065,0.158051689860835
"United States","Maryland","MD",2021-04-11,2021-04-17,7,2021,"15",6045680,1040,101,1002,38,939,1.67061438911752,0.628547987984809,0.0379241516966067
"United States","Maryland","MD",2021-04-18,2021-04-24,7,2021,"16",6045680,1109,109,978,131,1000,1.80294028132485,2.166836484895,0.133946830265849
"United States","Maryland","MD",2021-04-25,2021-05-01,7,2021,"17",6045680,1087,97,969,118,990,1.60445144301385,1.95180691005809,0.121775025799794
"United States","Maryland","MD",2021-05-02,2021-05-08,7,2021,"18",6045680,1021,110,948,73,911,1.81948101785076,1.20747376639187,0.0770042194092826
"United States","Maryland","MD",2021-05-09,2021-05-15,7,2021,"19",6045680,1054,71,943,111,983,1.17439229334004,1.83602175437668,0.117709437963945
"United States","Maryland","MD",2021-05-16,2021-05-22,7,2021,"20",6045680,1012,80,927,85,932,1.32325892207328,1.40596260470286,0.0916936353829558
"United States","Maryland","MD",2021-05-23,2021-05-29,7,2021,"21",6045680,1036,612,935,101,424,10.1229307538606,1.67061438911752,0.108021390374331
"United States","Maryland","MD",2021-05-30,2021-06-05,7,2021,"22",6045680,1017,41,935,82,976,0.678170197562557,1.35634039512511,0.0877005347593582
"United States","Maryland","MD",2021-06-06,2021-06-12,7,2021,"23",6045680,901,48,939,-38,853,0.793955353243969,-0.628547987984809,-0.0404685835995741
"United States","Maryland","MD",2021-06-13,2021-06-19,7,2021,"24",6045680,957,33,946,11,924,0.545844305355229,0.181948101785076,0.0116279069767442
"United States","Maryland","MD",2021-06-20,2021-06-26,7,2021,"25",6045680,922,30,953,-31,892,0.496222095777481,-0.512762832303397,-0.0325288562434418
"United States","Maryland","MD",2021-06-27,2021-07-03,7,2021,"26",6045680,987,17,942,45,970,0.281192520940572,0.744333143666221,0.0477707006369428
"United States","Maryland","MD",2021-07-04,2021-07-10,7,2021,"27",6045680,807,15,941,-134,792,0.24811104788874,-2.21645869447275,-0.14240170031881
"United States","Massachusetts","MA",2019-12-29,2020-01-04,7,2020,"1",6949503,1242,0,1362,-120,1242,0,-1.72674218573616,-0.0881057268722467
"United States","Massachusetts","MA",2020-01-05,2020-01-11,7,2020,"2",6949503,1266,0,1367,-101,1266,0,-1.45334133966127,-0.0738844184345282
"United States","Massachusetts","MA",2020-01-12,2020-01-18,7,2020,"3",6949503,1189,0,1370,-181,1189,0,-2.60450279681871,-0.132116788321168
"United States","Massachusetts","MA",2020-01-19,2020-01-25,7,2020,"4",6949503,1302,0,1347,-45,1302,0,-0.64752831965106,-0.0334075723830735
"United States","Massachusetts","MA",2020-01-26,2020-02-01,7,2020,"5",6949503,1205,0,1325,-120,1205,0,-1.72674218573616,-0.090566037735849
"United States","Massachusetts","MA",2020-02-02,2020-02-08,7,2020,"6",6949503,1233,0,1302,-69,1233,0,-0.992876756798292,-0.0529953917050692
"United States","Massachusetts","MA",2020-02-09,2020-02-15,7,2020,"7",6949503,1251,0,1283,-32,1251,0,-0.460464582862976,-0.0249415432579891
"United States","Massachusetts","MA",2020-02-16,2020-02-22,7,2020,"8",6949503,1166,0,1269,-103,1166,0,-1.4821203760902,-0.0811662726556344
"United States","Massachusetts","MA",2020-02-23,2020-02-29,7,2020,"9",6949503,1278,0,1244,34,1278,0,0.489243619291912,0.027331189710611
"United States","Massachusetts","MA",2020-03-01,2020-03-07,7,2020,"10",6949503,1216,0,1241,-25,1216,0,-0.3597379553617,-0.0201450443190975
"United States","Massachusetts","MA",2020-03-08,2020-03-14,7,2020,"11",6949503,1311,0,1234,77,1311,0,1.10799290251404,0.0623987034035656
"United States","Massachusetts","MA",2020-03-15,2020-03-21,7,2020,"12",6949503,1170,2,1226,-56,1168,0.028779036428936,-0.805813020010208,-0.0456769983686787
"United States","Massachusetts","MA",2020-03-22,2020-03-28,7,2020,"13",6949503,1290,42,1216,74,1248,0.604359765007656,1.06482434787063,0.0608552631578947
"United States","Massachusetts","MA",2020-03-29,2020-04-04,7,2020,"14",6949503,1549,172,1213,336,1377,2.4749971328885,4.83487812006125,0.276999175597692
"United States","Massachusetts","MA",2020-04-05,2020-04-11,7,2020,"15",6949503,2038,470,1197,841,1568,6.76307356079996,12.1015848183676,0.702589807852966
"United States","Massachusetts","MA",2020-04-12,2020-04-18,7,2020,"16",6949503,2494,874,1194,1300,1620,12.576438919445,18.7063736788084,1.08877721943049
"United States","Massachusetts","MA",2020-04-19,2020-04-25,7,2020,"17",6949503,2535,1170,1179,1356,1365,16.8357363109276,19.5121866988186,1.1501272264631
"United States","Massachusetts","MA",2020-04-26,2020-05-02,7,2020,"18",6949503,2310,1116,1164,1146,1194,16.0587023273463,16.4903878737803,0.984536082474227
"United States","Massachusetts","MA",2020-05-03,2020-05-09,7,2020,"19",6949503,2071,994,1140,931,1077,14.3031811051812,13.3966414576697,0.816666666666667
"United States","Massachusetts","MA",2020-05-10,2020-05-16,7,2020,"20",6949503,1886,865,1145,741,1021,12.4469332555148,10.6626329969208,0.647161572052402
"United States","Massachusetts","MA",2020-05-17,2020-05-23,7,2020,"21",6949503,1578,599,1135,443,979,8.61932141046633,6.37455656900932,0.390308370044053
"United States","Massachusetts","MA",2020-05-24,2020-05-30,7,2020,"22",6949503,1360,464,1120,240,896,6.67673645151315,3.45348437147232,0.214285714285714
"United States","Massachusetts","MA",2020-05-31,2020-06-06,7,2020,"23",6949503,1236,521,1116,120,715,7.49693898973783,1.72674218573616,0.10752688172043
"United States","Massachusetts","MA",2020-06-07,2020-06-13,7,2020,"24",6949503,1140,287,1109,31,853,4.12979172755232,0.446075064648508,0.0279531109107305
"United States","Massachusetts","MA",2020-06-14,2020-06-20,7,2020,"25",6949503,1129,251,1104,25,878,3.61176907183147,0.3597379553617,0.0226449275362319
"United States","Massachusetts","MA",2020-06-21,2020-06-27,7,2020,"26",6949503,1084,214,1097,-13,870,3.07935689789615,-0.187063736788084,-0.0118505013673655
"United States","Massachusetts","MA",2020-06-28,2020-07-04,7,2020,"27",6949503,1048,130,1098,-50,918,1.87063736788084,-0.7194759107234,-0.0455373406193078
"United States","Massachusetts","MA",2020-07-05,2020-07-11,7,2020,"28",6949503,1047,139,1089,-42,908,2.00014303181105,-0.604359765007656,-0.0385674931129476
"United States","Massachusetts","MA",2020-07-12,2020-07-18,7,2020,"29",6949503,1060,109,1089,-29,951,1.56845748537701,-0.417296028219572,-0.0266299357208448
"United States","Massachusetts","MA",2020-07-19,2020-07-25,7,2020,"30",6949503,1089,91,1081,8,998,1.30944615751659,0.115116145715744,0.00740055504162807
"United States","Massachusetts","MA",2020-07-26,2020-08-01,7,2020,"31",6949503,1022,116,1073,-51,906,1.66918411287829,-0.733865428937868,-0.0475302889095992
"United States","Massachusetts","MA",2020-08-02,2020-08-08,7,2020,"32",6949503,996,95,1077,-81,901,1.36700423037446,-1.16555097537191,-0.075208913649025
"United States","Massachusetts","MA",2020-08-09,2020-08-15,7,2020,"33",6949503,1049,99,1079,-30,950,1.42456230323233,-0.43168554643404,-0.0278035217794254
"United States","Massachusetts","MA",2020-08-16,2020-08-22,7,2020,"34",6949503,1037,101,1078,-41,936,1.45334133966127,-0.589970246793188,-0.0380333951762524
"United States","Massachusetts","MA",2020-08-23,2020-08-29,7,2020,"35",6949503,1059,115,1080,-21,944,1.65479459466382,-0.302179882503828,-0.0194444444444445
"United States","Massachusetts","MA",2020-08-30,2020-09-05,7,2020,"36",6949503,1014,80,1076,-62,934,1.15116145715744,-0.892150129297016,-0.0576208178438662
"United States","Massachusetts","MA",2020-09-06,2020-09-12,7,2020,"37",6949503,1012,80,1066,-54,932,1.15116145715744,-0.777033983581272,-0.050656660412758
"United States","Massachusetts","MA",2020-09-13,2020-09-19,7,2020,"38",6949503,1094,99,1075,19,995,1.42456230323233,0.273400846074892,0.0176744186046511
"United States","Massachusetts","MA",2020-09-20,2020-09-26,7,2020,"39",6949503,1125,96,1087,38,1029,1.38139374858893,0.546801692149784,0.0349586016559338
"United States","Massachusetts","MA",2020-09-27,2020-10-03,7,2020,"40",6949503,1105,116,1094,11,989,1.66918411287829,0.158284700359148,0.0100548446069471
"United States","Massachusetts","MA",2020-10-04,2020-10-10,7,2020,"41",6949503,1101,80,1097,4,1021,1.15116145715744,0.057558072857872,0.00364630811303557
"United States","Massachusetts","MA",2020-10-11,2020-10-17,7,2020,"42",6949503,1131,136,1104,27,995,1.95697447716765,0.388516991790636,0.0244565217391304
"United States","Massachusetts","MA",2020-10-18,2020-10-24,7,2020,"43",6949503,1196,116,1120,76,1080,1.66918411287829,1.09360338429957,0.0678571428571428
"United States","Massachusetts","MA",2020-10-25,2020-10-31,7,2020,"44",6949503,1089,152,1132,-43,937,2.18720676859914,-0.618749283222124,-0.0379858657243817
"United States","Massachusetts","MA",2020-11-01,2020-11-07,7,2020,"45",6949503,1218,134,1148,70,1084,1.92819544073871,1.00726627501276,0.0609756097560976
"United States","Massachusetts","MA",2020-11-08,2020-11-14,7,2020,"46",6949503,1234,168,1146,88,1066,2.41743906003062,1.26627760287318,0.0767888307155322
"United States","Massachusetts","MA",2020-11-15,2020-11-21,7,2020,"47",6949503,1214,195,1158,56,1019,2.80595605182126,0.805813020010208,0.0483592400690847
"United States","Massachusetts","MA",2020-11-22,2020-11-28,7,2020,"48",6949503,1261,188,1156,105,1073,2.70522942431998,1.51089941251914,0.0908304498269896
"United States","Massachusetts","MA",2020-11-29,2020-12-05,7,2020,"49",6949503,1331,277,1169,162,1054,3.98589654540764,2.33110195074382,0.13857998289136
"United States","Massachusetts","MA",2020-12-06,2020-12-12,7,2020,"50",6949503,1351,354,1175,176,997,5.09388944792167,2.53255520574637,0.149787234042553
"United States","Massachusetts","MA",2020-12-13,2020-12-19,7,2020,"51",6949503,1426,350,1193,233,1076,5.0363313750638,3.35275774397104,0.195305951383068
"United States","Massachusetts","MA",2020-12-20,2020-12-26,7,2020,"52",6949503,1552,60,1192,360,1492,0.86337109286808,5.18022655720848,0.302013422818792
"United States","Massachusetts","MA",2020-12-27,2021-01-02,7,2020,"53",6949503,1524,785,1233,291,739,11.2957717983574,4.18734980041019,0.236009732360097
"United States","Massachusetts","MA",2021-01-03,2021-01-09,7,2021,"1",6949503,1556,572,1250,306,984,8.2308044186757,4.40319257362721,0.2448
"United States","Massachusetts","MA",2021-01-10,2021-01-16,7,2021,"2",6949503,1558,509,1252,306,1049,7.32426477116421,4.40319257362721,0.244408945686901
"United States","Massachusetts","MA",2021-01-17,2021-01-23,7,2021,"3",6949503,1523,481,1266,257,1042,6.92135826115911,3.69810618111828,0.203001579778831
"United States","Massachusetts","MA",2021-01-24,2021-01-30,7,2021,"4",6949503,1579,467,1261,318,1112,6.71990500615656,4.57586679220082,0.25218080888184
"United States","Massachusetts","MA",2021-01-31,2021-02-06,7,2021,"5",6949503,1512,390,1250,262,1122,5.61191210364252,3.77005377219062,0.2096
"United States","Massachusetts","MA",2021-02-07,2021-02-13,7,2021,"6",6949503,1372,503,1245,127,869,7.2379276618774,1.82746881323744,0.102008032128514
"United States","Massachusetts","MA",2021-02-14,2021-02-20,7,2021,"7",6949503,1351,355,1238,113,996,5.10827896613614,1.62601555823488,0.0912762520193862
"United States","Massachusetts","MA",2021-02-21,2021-02-27,7,2021,"8",6949503,1274,288,1228,46,986,4.14418124576678,0.661917837865528,0.0374592833876222
"United States","Massachusetts","MA",2021-02-28,2021-03-06,7,2021,"9",6949503,1226,307,1201,25,919,4.41758209184168,0.3597379553617,0.0208159866777686
"United States","Massachusetts","MA",2021-03-07,2021-03-13,7,2021,"10",6949503,1218,206,1187,31,1012,2.96424075218041,0.446075064648508,0.0261162594776747
"United States","Massachusetts","MA",2021-03-14,2021-03-20,7,2021,"11",6949503,1206,252,1181,25,954,3.62615859004594,0.3597379553617,0.0211685012701102
"United States","Massachusetts","MA",2021-03-21,2021-03-27,7,2021,"12",6949503,1153,219,1177,-24,934,3.15130448896849,-0.345348437147232,-0.0203908241291418
"United States","Massachusetts","MA",2021-03-28,2021-04-03,7,2021,"13",6949503,1125,230,1175,-50,895,3.30958918932764,-0.7194759107234,-0.0425531914893617
"United States","Massachusetts","MA",2021-04-04,2021-04-10,7,2021,"14",6949503,1121,98,1172,-51,1023,1.41017278501786,-0.733865428937868,-0.0435153583617748
"United States","Massachusetts","MA",2021-04-11,2021-04-17,7,2021,"15",6949503,1145,76,1152,-7,1069,1.09360338429957,-0.100726627501276,-0.00607638888888884
"United States","Massachusetts","MA",2021-04-18,2021-04-24,7,2021,"16",6949503,1105,89,1143,-38,1016,1.28066712108765,-0.546801692149784,-0.0332458442694663
"United States","Massachusetts","MA",2021-04-25,2021-05-01,7,2021,"17",6949503,1122,73,1123,-1,1049,1.05043482965616,-0.014389518214468,-0.000890471950133587
"United States","Massachusetts","MA",2021-05-02,2021-05-08,7,2021,"18",6949503,1143,59,1104,39,1084,0.848981574653612,0.561191210364252,0.0353260869565217
"United States","Massachusetts","MA",2021-05-09,2021-05-15,7,2021,"19",6949503,1110,66,1099,11,1044,0.949708202154888,0.158284700359148,0.0100090991810737
"United States","Massachusetts","MA",2021-05-16,2021-05-22,7,2021,"20",6949503,1173,76,1100,73,1097,1.09360338429957,1.05043482965616,0.0663636363636364
"United States","Massachusetts","MA",2021-05-23,2021-05-29,7,2021,"21",6949503,1082,50,1088,-6,1032,0.7194759107234,-0.086337109286808,-0.00551470588235292
"United States","Massachusetts","MA",2021-05-30,2021-06-05,7,2021,"22",6949503,1089,39,1085,4,1050,0.561191210364252,0.057558072857872,0.00368663594470053
"United States","Massachusetts","MA",2021-06-06,2021-06-12,7,2021,"23",6949503,1085,30,1081,4,1055,0.43168554643404,0.057558072857872,0.00370027752081414
"United States","Massachusetts","MA",2021-06-13,2021-06-19,7,2021,"24",6949503,1025,23,1083,-58,1002,0.330958918932764,-0.834592056439144,-0.0535549399815328
"United States","Massachusetts","MA",2021-06-20,2021-06-26,7,2021,"25",6949503,1059,25,1082,-23,1034,0.3597379553617,-0.330958918932764,-0.0212569316081331
"United States","Massachusetts","MA",2021-06-27,2021-07-03,7,2021,"26",6949503,1001,12,1089,-88,989,0.172674218573616,-1.26627760287318,-0.0808080808080808
"United States","Massachusetts","MA",2021-07-04,2021-07-10,7,2021,"27",6949503,949,15,1080,-131,934,0.21584277321702,-1.88502688609531,-0.121296296296296
"United States","Michigan","MI",2019-12-29,2020-01-04,7,2020,"1",9986857,2015,0,2099,-84,2015,0,-0.841105464912534,-0.0400190566936637
"United States","Michigan","MI",2020-01-05,2020-01-11,7,2020,"2",9986857,2065,0,2121,-56,2065,0,-0.560736976608356,-0.0264026402640264
"United States","Michigan","MI",2020-01-12,2020-01-18,7,2020,"3",9986857,1936,0,2116,-180,1936,0,-1.802368853384,-0.0850661625708885
"United States","Michigan","MI",2020-01-19,2020-01-25,7,2020,"4",9986857,2012,0,2102,-90,2012,0,-0.901184426692001,-0.0428163653663178
"United States","Michigan","MI",2020-01-26,2020-02-01,7,2020,"5",9986857,2004,0,2089,-85,2004,0,-0.851118625209112,-0.0406893250359024
"United States","Michigan","MI",2020-02-02,2020-02-08,7,2020,"6",9986857,1940,0,2071,-131,1940,0,-1.31172399885169,-0.0632544664413327
"United States","Michigan","MI",2020-02-09,2020-02-15,7,2020,"7",9986857,2014,0,2058,-44,2014,0,-0.440579053049423,-0.0213799805636541
"United States","Michigan","MI",2020-02-16,2020-02-22,7,2020,"8",9986857,2056,0,2055,1,2056,0,0.0100131602965778,0.000486618004866157
"United States","Michigan","MI",2020-02-23,2020-02-29,7,2020,"9",9986857,1973,0,2034,-61,1973,0,-0.610802778091245,-0.0299901671583087
"United States","Michigan","MI",2020-03-01,2020-03-07,7,2020,"10",9986857,1988,0,2024,-36,1988,0,-0.360473770676801,-0.0177865612648221
"United States","Michigan","MI",2020-03-08,2020-03-14,7,2020,"11",9986857,1955,0,2016,-61,1955,0,-0.610802778091245,-0.0302579365079365
"United States","Michigan","MI",2020-03-15,2020-03-21,7,2020,"12",9986857,2036,5,2002,34,2031,0.050065801482889,0.340447450083645,0.016983016983017
"United States","Michigan","MI",2020-03-22,2020-03-28,7,2020,"13",9986857,2432,99,2009,423,2333,0.991302869361201,4.23556680545241,0.210552513688402
"United States","Michigan","MI",2020-03-29,2020-04-04,7,2020,"14",9986857,3117,436,1988,1129,2681,4.36573788930792,11.3048579748363,0.567907444668008
"United States","Michigan","MI",2020-04-05,2020-04-11,7,2020,"15",9986857,3385,851,1969,1416,2534,8.5211994123877,14.1786349799542,0.719146775012697
"United States","Michigan","MI",2020-04-12,2020-04-18,7,2020,"16",9986857,3159,918,1943,1216,2241,9.19208115225841,12.1760029206386,0.625836335563561
"United States","Michigan","MI",2020-04-19,2020-04-25,7,2020,"17",9986857,2806,966,1913,893,1840,9.67271284649415,8.94175214484397,0.466806063774177
"United States","Michigan","MI",2020-04-26,2020-05-02,7,2020,"18",9986857,2588,745,1880,708,1843,7.45980442095046,7.08931748997708,0.376595744680851
"United States","Michigan","MI",2020-05-03,2020-05-09,7,2020,"19",9986857,2241,505,1840,401,1736,5.05664594977179,4.01527727892769,0.217934782608696
"United States","Michigan","MI",2020-05-10,2020-05-16,7,2020,"20",9986857,2160,354,1826,334,1806,3.54465874498854,3.34439553905698,0.182913472070099
"United States","Michigan","MI",2020-05-17,2020-05-23,7,2020,"21",9986857,2012,340,1809,203,1672,3.40447450083645,2.03267154020529,0.112216694306247
"United States","Michigan","MI",2020-05-24,2020-05-30,7,2020,"22",9986857,1962,244,1811,151,1718,2.44321111236498,1.51198720478325,0.0833793484262839
"United States","Michigan","MI",2020-05-31,2020-06-06,7,2020,"23",9986857,2000,426,1812,188,1574,4.26560628634214,1.88247413575663,0.103752759381899
"United States","Michigan","MI",2020-06-07,2020-06-13,7,2020,"24",9986857,1860,122,1799,61,1738,1.22160555618249,0.610802778091245,0.0339077265147305
"United States","Michigan","MI",2020-06-14,2020-06-20,7,2020,"25",9986857,1885,75,1804,81,1810,0.750987022243334,0.811065984022801,0.04490022172949
"United States","Michigan","MI",2020-06-21,2020-06-27,7,2020,"26",9986857,1918,67,1802,116,1851,0.670881739870712,1.16152659440302,0.0643729189789124
"United States","Michigan","MI",2020-06-28,2020-07-04,7,2020,"27",9986857,1984,65,1784,200,1919,0.650855419277557,2.00263205931556,0.112107623318386
"United States","Michigan","MI",2020-07-05,2020-07-11,7,2020,"28",9986857,1890,95,1767,123,1795,0.95125022817489,1.23161871647907,0.069609507640068
"United States","Michigan","MI",2020-07-12,2020-07-18,7,2020,"29",9986857,1879,51,1754,125,1828,0.510671175125467,1.25164503707222,0.0712656784492589
"United States","Michigan","MI",2020-07-19,2020-07-25,7,2020,"30",9986857,1891,36,1744,147,1855,0.360473770676801,1.47193456359694,0.0842889908256881
"United States","Michigan","MI",2020-07-26,2020-08-01,7,2020,"31",9986857,1969,57,1744,225,1912,0.570750136904934,2.25296106673,0.12901376146789
"United States","Michigan","MI",2020-08-02,2020-08-08,7,2020,"32",9986857,1868,63,1737,131,1805,0.630829098684401,1.31172399885169,0.0754173862982153
"United States","Michigan","MI",2020-08-09,2020-08-15,7,2020,"33",9986857,2025,66,1734,291,1959,0.660868579574134,2.91382964630414,0.167820069204152
"United States","Michigan","MI",2020-08-16,2020-08-22,7,2020,"34",9986857,1926,69,1734,192,1857,0.690908060463868,1.92252677694294,0.110726643598616
"United States","Michigan","MI",2020-08-23,2020-08-29,7,2020,"35",9986857,1936,57,1724,212,1879,0.570750136904934,2.12278998287449,0.122969837587007
"United States","Michigan","MI",2020-08-30,2020-09-05,7,2020,"36",9986857,1959,94,1729,230,1865,0.941237067878313,2.30302686821289,0.133024869866975
"United States","Michigan","MI",2020-09-06,2020-09-12,7,2020,"37",9986857,1942,105,1727,215,1837,1.05138183114067,2.15282946376423,0.124493341053851
"United States","Michigan","MI",2020-09-13,2020-09-19,7,2020,"38",9986857,1905,58,1744,161,1847,0.580763297201512,1.61211880774902,0.0923165137614679
"United States","Michigan","MI",2020-09-20,2020-09-26,7,2020,"39",9986857,2006,75,1759,247,1931,0.750987022243334,2.47325059325471,0.140420693575895
"United States","Michigan","MI",2020-09-27,2020-10-03,7,2020,"40",9986857,2033,80,1778,255,1953,0.801052823726223,2.55335587562734,0.143419572553431
"United States","Michigan","MI",2020-10-04,2020-10-10,7,2020,"41",9986857,2146,95,1794,352,2051,0.95125022817489,3.52463242439538,0.196209587513935
"United States","Michigan","MI",2020-10-11,2020-10-17,7,2020,"42",9986857,2029,121,1808,221,1908,1.21159239588591,2.21290842554369,0.122234513274336
"United States","Michigan","MI",2020-10-18,2020-10-24,7,2020,"43",9986857,2207,182,1821,386,2025,1.82239517397716,3.86507987447903,0.211971444261395
"United States","Michigan","MI",2020-10-25,2020-10-31,7,2020,"44",9986857,2176,174,1818,358,2002,1.74228989160454,3.58471138617485,0.196919691969197
"United States","Michigan","MI",2020-11-01,2020-11-07,7,2020,"45",9986857,2347,181,1832,515,2166,1.81238201368058,5.15677755273756,0.281113537117904
"United States","Michigan","MI",2020-11-08,2020-11-14,7,2020,"46",9986857,2427,494,1826,601,1933,4.94650118650943,6.01790933824325,0.329134720700986
"United States","Michigan","MI",2020-11-15,2020-11-21,7,2020,"47",9986857,2623,503,1842,781,2120,5.03661962917863,7.82027819162726,0.42399565689468
"United States","Michigan","MI",2020-11-22,2020-11-28,7,2020,"48",9986857,2661,588,1844,817,2073,5.88773825438774,8.18075196230406,0.443058568329718
"United States","Michigan","MI",2020-11-29,2020-12-05,7,2020,"49",9986857,2805,855,1861,944,1950,8.56125205357401,9.45242331996944,0.507254164427727
"United States","Michigan","MI",2020-12-06,2020-12-12,7,2020,"50",9986857,2958,878,1870,1088,2080,8.7915547403953,10.8943184026766,0.581818181818182
"United States","Michigan","MI",2020-12-13,2020-12-19,7,2020,"51",9986857,2766,878,1895,871,1888,8.7915547403953,8.72146261831926,0.459630606860158
"United States","Michigan","MI",2020-12-20,2020-12-26,7,2020,"52",9986857,2633,616,1921,712,2017,6.16810674269192,7.12937013116339,0.370640291514836
"United States","Michigan","MI",2020-12-27,2021-01-02,7,2020,"53",9986857,2552,615,1955,597,1937,6.15809358239534,5.97785669705694,0.30537084398977
"United States","Michigan","MI",2021-01-03,2021-01-09,7,2021,"1",9986857,2354,841,1987,367,1513,8.42106780942192,3.67482982884405,0.184700553598389
"United States","Michigan","MI",2021-01-10,2021-01-16,7,2021,"2",9986857,2394,509,2010,384,1885,5.0966985909581,3.84505355388587,0.191044776119403
"United States","Michigan","MI",2021-01-17,2021-01-23,7,2021,"3",9986857,2340,524,2015,325,1816,5.24689599540676,3.25427709638778,0.161290322580645
"United States","Michigan","MI",2021-01-24,2021-01-30,7,2021,"4",9986857,2209,347,2019,190,1862,3.47456662291249,1.90250045634978,0.0941059930658743
"United States","Michigan","MI",2021-01-31,2021-02-06,7,2021,"5",9986857,2307,331,1996,311,1976,3.31435605816725,3.11409285223569,0.155811623246493
"United States","Michigan","MI",2021-02-07,2021-02-13,7,2021,"6",9986857,2100,265,2007,93,1835,2.65348747859312,0.931223907581735,0.0463378176382661
"United States","Michigan","MI",2021-02-14,2021-02-20,7,2021,"7",9986857,2121,222,1992,129,1899,2.22292158584027,1.29169767825854,0.0647590361445782
"United States","Michigan","MI",2021-02-21,2021-02-27,7,2021,"8",9986857,2088,166,1994,94,1922,1.66218460923191,0.941237067878313,0.0471414242728185
"United States","Michigan","MI",2021-02-28,2021-03-06,7,2021,"9",9986857,2045,151,1991,54,1894,1.51198720478325,0.540710656015201,0.0271220492214967
"United States","Michigan","MI",2021-03-07,2021-03-13,7,2021,"10",9986857,1886,115,1978,-92,1771,1.15151343410645,-0.921210747285157,-0.0465116279069767
"United States","Michigan","MI",2021-03-14,2021-03-20,7,2021,"11",9986857,2045,134,1959,86,1911,1.34176347974142,0.86113178550569,0.0438999489535477
"United States","Michigan","MI",2021-03-21,2021-03-27,7,2021,"12",9986857,2128,141,1957,171,1987,1.41185560181747,1.7122504107148,0.087378640776699
"United States","Michigan","MI",2021-03-28,2021-04-03,7,2021,"13",9986857,2093,210,1951,142,1883,2.10276366228134,1.42186876211405,0.0727831881086622
"United States","Michigan","MI",2021-04-04,2021-04-10,7,2021,"14",9986857,2386,303,1940,446,2083,3.03398756986307,4.4658694922737,0.229896907216495
"United States","Michigan","MI",2021-04-11,2021-04-17,7,2021,"15",9986857,2340,371,1938,402,1969,3.71488247003036,4.02529043922427,0.207430340557275
"United States","Michigan","MI",2021-04-18,2021-04-24,7,2021,"16",9986857,2479,475,1913,566,2004,4.75625114087445,5.66744872786303,0.295870360690016
"United States","Michigan","MI",2021-04-25,2021-05-01,7,2021,"17",9986857,2412,484,1893,519,1928,4.84636958354365,5.19683019392387,0.274167987321712
"United States","Michigan","MI",2021-05-02,2021-05-08,7,2021,"18",9986857,2342,484,1875,467,1858,4.84636958354365,4.67614585850183,0.249066666666667
"United States","Michigan","MI",2021-05-09,2021-05-15,7,2021,"19",9986857,2274,413,1853,421,1861,4.13543520248663,4.21554048485925,0.227199136535348
"United States","Michigan","MI",2021-05-16,2021-05-22,7,2021,"20",9986857,2347,350,1844,503,1997,3.50460610380223,5.03661962917863,0.272776572668113
"United States","Michigan","MI",2021-05-23,2021-05-29,7,2021,"21",9986857,2149,236,1835,314,1913,2.36310582999236,3.14413233312543,0.171117166212534
"United States","Michigan","MI",2021-05-30,2021-06-05,7,2021,"22",9986857,2117,212,1831,286,1905,2.12278998287449,2.86376384482125,0.156198798470781
"United States","Michigan","MI",2021-06-06,2021-06-12,7,2021,"23",9986857,2137,190,1829,308,1947,1.90250045634978,3.08405337134596,0.168398031711318
"United States","Michigan","MI",2021-06-13,2021-06-19,7,2021,"24",9986857,2041,84,1836,205,1957,0.841105464912534,2.05269786079845,0.111655773420479
"United States","Michigan","MI",2021-06-20,2021-06-26,7,2021,"25",9986857,2076,97,1842,234,1979,0.971276548768046,2.3430795093992,0.127035830618893
"United States","Michigan","MI",2021-06-27,2021-07-03,7,2021,"26",9986857,1869,50,1842,27,1819,0.50065801482889,0.2703553280076,0.0146579804560261
"United States","Michigan","MI",2021-07-04,2021-07-10,7,2021,"27",9986857,1661,50,1832,-171,1611,0.50065801482889,-1.7122504107148,-0.0933406113537117
"United States","Minnesota","MN",2019-12-29,2020-01-04,7,2020,"1",5639632,1009,0,991,18,1009,0,0.319169761431242,0.0181634712411705
"United States","Minnesota","MN",2020-01-05,2020-01-11,7,2020,"2",5639632,950,0,972,-22,950,0,-0.390096375082629,-0.022633744855967
"United States","Minnesota","MN",2020-01-12,2020-01-18,7,2020,"3",5639632,946,0,965,-19,946,0,-0.336901414844089,-0.0196891191709845
"United States","Minnesota","MN",2020-01-19,2020-01-25,7,2020,"4",5639632,955,0,952,3,955,0,0.0531949602385404,0.00315126050420167
"United States","Minnesota","MN",2020-01-26,2020-02-01,7,2020,"5",5639632,942,0,953,-11,942,0,-0.195048187541315,-0.0115424973767051
"United States","Minnesota","MN",2020-02-02,2020-02-08,7,2020,"6",5639632,919,0,952,-33,919,0,-0.585144562623944,-0.0346638655462185
"United States","Minnesota","MN",2020-02-09,2020-02-15,7,2020,"7",5639632,941,0,943,-2,941,0,-0.0354633068256936,-0.00212089077412514
"United States","Minnesota","MN",2020-02-16,2020-02-22,7,2020,"8",5639632,913,0,937,-24,913,0,-0.425559681908323,-0.0256136606189968
"United States","Minnesota","MN",2020-02-23,2020-02-29,7,2020,"9",5639632,933,0,933,0,933,0,0,0
"United States","Minnesota","MN",2020-03-01,2020-03-07,7,2020,"10",5639632,944,0,934,10,944,0,0.177316534128468,0.0107066381156318
"United States","Minnesota","MN",2020-03-08,2020-03-14,7,2020,"11",5639632,882,0,914,-32,882,0,-0.567412909211097,-0.0350109409190372
"United States","Minnesota","MN",2020-03-15,2020-03-21,7,2020,"12",5639632,894,1,906,-12,893,0.0177316534128468,-0.212779840954162,-0.0132450331125827
"United States","Minnesota","MN",2020-03-22,2020-03-28,7,2020,"13",5639632,909,4,907,2,905,0.0709266136513872,0.0354633068256936,0.00220507166482919
"United States","Minnesota","MN",2020-03-29,2020-04-04,7,2020,"14",5639632,928,19,913,15,909,0.336901414844089,0.265974801192702,0.0164293537787514
"United States","Minnesota","MN",2020-04-05,2020-04-11,7,2020,"15",5639632,943,40,910,33,903,0.709266136513872,0.585144562623944,0.0362637362637364
"United States","Minnesota","MN",2020-04-12,2020-04-18,7,2020,"16",5639632,955,57,891,64,898,1.01070424453227,1.13482581842219,0.0718294051627384
"United States","Minnesota","MN",2020-04-19,2020-04-25,7,2020,"17",5639632,1016,122,883,133,894,2.16326171636731,2.35830990390862,0.150622876557191
"United States","Minnesota","MN",2020-04-26,2020-05-02,7,2020,"18",5639632,1042,150,865,177,892,2.65974801192702,3.13850265407388,0.204624277456647
"United States","Minnesota","MN",2020-05-03,2020-05-09,7,2020,"19",5639632,1057,164,857,200,893,2.90799115970687,3.54633068256936,0.233372228704784
"United States","Minnesota","MN",2020-05-10,2020-05-16,7,2020,"20",5639632,1000,141,847,153,859,2.5001631312114,2.71294297216556,0.180637544273908
"United States","Minnesota","MN",2020-05-17,2020-05-23,7,2020,"21",5639632,1005,150,849,156,855,2.65974801192702,2.7661379324041,0.183745583038869
"United States","Minnesota","MN",2020-05-24,2020-05-30,7,2020,"22",5639632,1017,176,839,178,841,3.12077100066104,3.15623430748673,0.212157330154946
"United States","Minnesota","MN",2020-05-31,2020-06-06,7,2020,"23",5639632,1038,143,833,205,895,2.53562643803709,3.63498894963359,0.24609843937575
"United States","Minnesota","MN",2020-06-07,2020-06-13,7,2020,"24",5639632,973,114,822,151,859,2.02140848906453,2.67747966533987,0.183698296836983
"United States","Minnesota","MN",2020-06-14,2020-06-20,7,2020,"25",5639632,941,91,829,112,850,1.61358046056906,1.98594518223884,0.135102533172497
"United States","Minnesota","MN",2020-06-21,2020-06-27,7,2020,"26",5639632,840,45,827,13,795,0.797924403578106,0.230511494367008,0.0157194679564692
"United States","Minnesota","MN",2020-06-28,2020-07-04,7,2020,"27",5639632,876,49,823,53,827,0.868851017229493,0.93977763088088,0.0643985419198057
"United States","Minnesota","MN",2020-07-05,2020-07-11,7,2020,"28",5639632,865,33,828,37,832,0.585144562623944,0.656071176275331,0.0446859903381642
"United States","Minnesota","MN",2020-07-12,2020-07-18,7,2020,"29",5639632,869,39,827,42,830,0.691534483101025,0.744729443339565,0.0507859733978235
"United States","Minnesota","MN",2020-07-19,2020-07-25,7,2020,"30",5639632,878,7,825,53,871,0.124121573889928,0.93977763088088,0.0642424242424242
"United States","Minnesota","MN",2020-07-26,2020-08-01,7,2020,"31",5639632,818,61,824,-6,757,1.08163085818365,-0.106389920477081,-0.00728155339805825
"United States","Minnesota","MN",2020-08-02,2020-08-08,7,2020,"32",5639632,897,42,832,65,855,0.744729443339565,1.15255747183504,0.078125
"United States","Minnesota","MN",2020-08-09,2020-08-15,7,2020,"33",5639632,888,51,833,55,837,0.904314324055187,0.975240937706574,0.0660264105642256
"United States","Minnesota","MN",2020-08-16,2020-08-22,7,2020,"34",5639632,907,62,831,76,845,1.0993625115965,1.34760565937636,0.0914560770156438
"United States","Minnesota","MN",2020-08-23,2020-08-29,7,2020,"35",5639632,919,53,836,83,866,0.93977763088088,1.47172723326628,0.0992822966507176
"United States","Minnesota","MN",2020-08-30,2020-09-05,7,2020,"36",5639632,895,37,841,54,858,0.656071176275331,0.957509284293727,0.0642092746730083
"United States","Minnesota","MN",2020-09-06,2020-09-12,7,2020,"37",5639632,893,55,848,45,838,0.975240937706574,0.797924403578106,0.0530660377358489
"United States","Minnesota","MN",2020-09-13,2020-09-19,7,2020,"38",5639632,957,57,858,99,900,1.01070424453227,1.75543368787183,0.115384615384615
"United States","Minnesota","MN",2020-09-20,2020-09-26,7,2020,"39",5639632,969,41,863,106,928,0.726997789926719,1.87955526176176,0.122827346465817
"United States","Minnesota","MN",2020-09-27,2020-10-03,7,2020,"40",5639632,886,69,871,15,817,1.22348408548643,0.265974801192702,0.0172215843857635
"United States","Minnesota","MN",2020-10-04,2020-10-10,7,2020,"41",5639632,1013,58,877,136,955,1.02843589794511,2.41150486414716,0.155074116305587
"United States","Minnesota","MN",2020-10-11,2020-10-17,7,2020,"42",5639632,953,20,880,73,933,0.354633068256936,1.29441069913782,0.0829545454545455
"United States","Minnesota","MN",2020-10-18,2020-10-24,7,2020,"43",5639632,1030,95,890,140,935,1.68450707422045,2.48243147779855,0.157303370786517
"United States","Minnesota","MN",2020-10-25,2020-10-31,7,2020,"44",5639632,1075,229,891,184,846,4.06054863154192,3.26262422796381,0.206509539842873
"United States","Minnesota","MN",2020-11-01,2020-11-07,7,2020,"45",5639632,1145,149,891,254,996,2.64201635851417,4.50383996686309,0.285072951739618
"United States","Minnesota","MN",2020-11-08,2020-11-14,7,2020,"46",5639632,1196,281,891,305,915,4.98259460900995,5.40815429091827,0.342312008978676
"United States","Minnesota","MN",2020-11-15,2020-11-21,7,2020,"47",5639632,1326,336,886,440,990,5.95783554671652,7.80192750165259,0.496613995485327
"United States","Minnesota","MN",2020-11-22,2020-11-28,7,2020,"48",5639632,1397,280,880,517,1117,4.9648629555971,9.16726481444179,0.5875
"United States","Minnesota","MN",2020-11-29,2020-12-05,7,2020,"49",5639632,1334,398,874,460,936,7.05719805831303,8.15656056990953,0.526315789473684
"United States","Minnesota","MN",2020-12-06,2020-12-12,7,2020,"50",5639632,1382,440,892,490,942,7.80192750165259,8.68851017229493,0.54932735426009
"United States","Minnesota","MN",2020-12-13,2020-12-19,7,2020,"51",5639632,1269,421,905,364,848,7.4650260868085,6.45432184227623,0.402209944751381
"United States","Minnesota","MN",2020-12-20,2020-12-26,7,2020,"52",5639632,1203,327,923,280,876,5.7982506660009,4.9648629555971,0.303358613217768
"United States","Minnesota","MN",2020-12-27,2021-01-02,7,2020,"53",5639632,1194,270,948,246,924,4.78754642146863,4.36198673956031,0.259493670886076
"United States","Minnesota","MN",2021-01-03,2021-01-09,7,2021,"1",5639632,1140,286,954,186,854,5.07125287607418,3.2980875347895,0.194968553459119
"United States","Minnesota","MN",2021-01-10,2021-01-16,7,2021,"2",5639632,1078,224,961,117,854,3.97189036447768,2.07460344930307,0.121748178980229
"United States","Minnesota","MN",2021-01-17,2021-01-23,7,2021,"3",5639632,947,176,958,-11,771,3.12077100066104,-0.195048187541315,-0.011482254697286
"United States","Minnesota","MN",2021-01-24,2021-01-30,7,2021,"4",5639632,929,124,939,-10,805,2.198725023193,-0.177316534128468,-0.0106496272630457
"United States","Minnesota","MN",2021-01-31,2021-02-06,7,2021,"5",5639632,988,103,935,53,885,1.82636030152322,0.93977763088088,0.0566844919786096
"United States","Minnesota","MN",2021-02-07,2021-02-13,7,2021,"6",5639632,916,80,925,-9,836,1.41853227302774,-0.159584880715621,-0.00972972972972974
"United States","Minnesota","MN",2021-02-14,2021-02-20,7,2021,"7",5639632,909,54,919,-10,855,0.957509284293727,-0.177316534128468,-0.0108813928182807
"United States","Minnesota","MN",2021-02-21,2021-02-27,7,2021,"8",5639632,973,53,901,72,920,0.93977763088088,1.27667904572497,0.0799112097669257
"United States","Minnesota","MN",2021-02-28,2021-03-06,7,2021,"9",5639632,937,69,894,43,868,1.22348408548643,0.762461096752412,0.0480984340044743
"United States","Minnesota","MN",2021-03-07,2021-03-13,7,2021,"10",5639632,868,195,895,-27,673,3.45767241550513,-0.478754642146863,-0.0301675977653632
"United States","Minnesota","MN",2021-03-14,2021-03-20,7,2021,"11",5639632,869,37,892,-23,832,0.656071176275331,-0.407828028495476,-0.0257847533632287
"United States","Minnesota","MN",2021-03-21,2021-03-27,7,2021,"12",5639632,868,47,882,-14,821,0.833387710403799,-0.248243147779855,-0.0158730158730159
"United States","Minnesota","MN",2021-03-28,2021-04-03,7,2021,"13",5639632,875,50,892,-17,825,0.88658267064234,-0.301438108018395,-0.0190582959641256
"United States","Minnesota","MN",2021-04-04,2021-04-10,7,2021,"14",5639632,876,69,889,-13,807,1.22348408548643,-0.230511494367008,-0.0146231721034871
"United States","Minnesota","MN",2021-04-11,2021-04-17,7,2021,"15",5639632,895,61,884,11,834,1.08163085818365,0.195048187541315,0.0124434389140271
"United States","Minnesota","MN",2021-04-18,2021-04-24,7,2021,"16",5639632,936,67,888,48,869,1.18802077866074,0.851119363816646,0.0540540540540539
"United States","Minnesota","MN",2021-04-25,2021-05-01,7,2021,"17",5639632,967,82,894,73,885,1.45399557985344,1.29441069913782,0.0816554809843399
"United States","Minnesota","MN",2021-05-02,2021-05-08,7,2021,"18",5639632,901,70,882,19,831,1.24121573889928,0.336901414844089,0.0215419501133787
"United States","Minnesota","MN",2021-05-09,2021-05-15,7,2021,"19",5639632,932,62,889,43,870,1.0993625115965,0.762461096752412,0.048368953880765
"United States","Minnesota","MN",2021-05-16,2021-05-22,7,2021,"20",5639632,876,77,879,-3,799,1.3653373127892,-0.0531949602385404,-0.0034129692832765
"United States","Minnesota","MN",2021-05-23,2021-05-29,7,2021,"21",5639632,846,55,855,-9,791,0.975240937706574,-0.159584880715621,-0.0105263157894737
"United States","Minnesota","MN",2021-05-30,2021-06-05,7,2021,"22",5639632,830,43,838,-8,787,0.762461096752412,-0.141853227302774,-0.00954653937947492
"United States","Minnesota","MN",2021-06-06,2021-06-12,7,2021,"23",5639632,849,42,832,17,807,0.744729443339565,0.301438108018395,0.0204326923076923
"United States","Minnesota","MN",2021-06-13,2021-06-19,7,2021,"24",5639632,792,33,828,-36,759,0.585144562623944,-0.638339522862485,-0.0434782608695652
"United States","Minnesota","MN",2021-06-20,2021-06-26,7,2021,"25",5639632,836,42,832,4,794,0.744729443339565,0.0709266136513872,0.00480769230769229
"United States","Minnesota","MN",2021-06-27,2021-07-03,7,2021,"26",5639632,800,32,830,-30,768,0.567412909211097,-0.531949602385404,-0.036144578313253
"United States","Minnesota","MN",2021-07-04,2021-07-10,7,2021,"27",5639632,746,12,831,-85,734,0.212779840954162,-1.50719054009198,-0.102286401925391
"United States","Mississippi","MS",2019-12-29,2020-01-04,7,2020,"1",2976149,673,0,706,-33,673,0,-1.10881545245215,-0.046742209631728
"United States","Mississippi","MS",2020-01-05,2020-01-11,7,2020,"2",2976149,648,0,709,-61,648,0,-2.04962856362366,-0.0860366713681241
"United States","Mississippi","MS",2020-01-12,2020-01-18,7,2020,"3",2976149,624,0,691,-67,624,0,-2.25123137316042,-0.0969609261939218
"United States","Mississippi","MS",2020-01-19,2020-01-25,7,2020,"4",2976149,612,0,673,-61,612,0,-2.04962856362366,-0.0906389301634473
"United States","Mississippi","MS",2020-01-26,2020-02-01,7,2020,"5",2976149,608,0,671,-63,608,0,-2.11682950013591,-0.0938897168405365
"United States","Mississippi","MS",2020-02-02,2020-02-08,7,2020,"6",2976149,703,0,678,25,703,0,0.84001170640314,0.0368731563421829
"United States","Mississippi","MS",2020-02-09,2020-02-15,7,2020,"7",2976149,648,0,666,-18,648,0,-0.604808428610261,-0.027027027027027
"United States","Mississippi","MS",2020-02-16,2020-02-22,7,2020,"8",2976149,625,0,657,-32,625,0,-1.07521498419602,-0.0487062404870624
"United States","Mississippi","MS",2020-02-23,2020-02-29,7,2020,"9",2976149,665,0,646,19,665,0,0.638408896866387,0.0294117647058822
"United States","Mississippi","MS",2020-03-01,2020-03-07,7,2020,"10",2976149,663,0,651,12,663,0,0.403205619073507,0.0184331797235022
"United States","Mississippi","MS",2020-03-08,2020-03-14,7,2020,"11",2976149,623,0,647,-24,623,0,-0.806411238147015,-0.0370942812982998
"United States","Mississippi","MS",2020-03-15,2020-03-21,7,2020,"12",2976149,625,1,639,-14,624,0.0336004682561256,-0.470406555585759,-0.0219092331768388
"United States","Mississippi","MS",2020-03-22,2020-03-28,7,2020,"13",2976149,698,5,630,68,693,0.168002341280628,2.28483184141654,0.107936507936508
"United States","Mississippi","MS",2020-03-29,2020-04-04,7,2020,"14",2976149,707,29,623,84,678,0.974413579427643,2.82243933351455,0.134831460674157
"United States","Mississippi","MS",2020-04-05,2020-04-11,7,2020,"15",2976149,699,57,619,80,642,1.91522669059916,2.68803746049005,0.12924071082391
"United States","Mississippi","MS",2020-04-12,2020-04-18,7,2020,"16",2976149,732,59,610,122,673,1.98242762711141,4.09925712724733,0.2
"United States","Mississippi","MS",2020-04-19,2020-04-25,7,2020,"17",2976149,750,69,607,143,681,2.31843230967267,4.80486696062596,0.235584843492586
"United States","Mississippi","MS",2020-04-26,2020-05-02,7,2020,"18",2976149,751,71,596,155,680,2.38563324618492,5.20807257969947,0.26006711409396
"United States","Mississippi","MS",2020-05-03,2020-05-09,7,2020,"19",2976149,748,128,590,158,620,4.30085993678408,5.30887398446785,0.267796610169492
"United States","Mississippi","MS",2020-05-10,2020-05-16,7,2020,"20",2976149,775,91,587,188,684,3.05764261130743,6.31688803215162,0.320272572402044
"United States","Mississippi","MS",2020-05-17,2020-05-23,7,2020,"21",2976149,725,106,593,132,619,3.56164963514932,4.43526180980858,0.222596964586847
"United States","Mississippi","MS",2020-05-24,2020-05-30,7,2020,"22",2976149,750,107,597,153,643,3.59525010340544,5.14087164318722,0.256281407035176
"United States","Mississippi","MS",2020-05-31,2020-06-06,7,2020,"23",2976149,728,88,593,135,640,2.95684120653905,4.53606321457696,0.227655986509275
"United States","Mississippi","MS",2020-06-07,2020-06-13,7,2020,"24",2976149,702,78,590,112,624,2.6208365239778,3.76325244468607,0.189830508474576
"United States","Mississippi","MS",2020-06-14,2020-06-20,7,2020,"25",2976149,743,49,594,149,694,1.64642294455016,5.00646977016272,0.250841750841751
"United States","Mississippi","MS",2020-06-21,2020-06-27,7,2020,"26",2976149,721,97,595,126,624,3.25924542084418,4.23365900027183,0.211764705882353
"United States","Mississippi","MS",2020-06-28,2020-07-04,7,2020,"27",2976149,711,72,590,121,639,2.41923371444104,4.0656566589912,0.205084745762712
"United States","Mississippi","MS",2020-07-05,2020-07-11,7,2020,"28",2976149,797,123,585,212,674,4.13285759550345,7.12329927029863,0.362393162393162
"United States","Mississippi","MS",2020-07-12,2020-07-18,7,2020,"29",2976149,784,116,574,210,668,3.89765431771057,7.05609833378638,0.365853658536585
"United States","Mississippi","MS",2020-07-19,2020-07-25,7,2020,"30",2976149,885,134,575,310,751,4.50246274632083,10.4161451593989,0.539130434782609
"United States","Mississippi","MS",2020-07-26,2020-08-01,7,2020,"31",2976149,872,212,570,302,660,7.12329927029863,10.1473414133499,0.529824561403509
"United States","Mississippi","MS",2020-08-02,2020-08-08,7,2020,"32",2976149,915,165,571,344,750,5.54407726226073,11.5585610801072,0.602451838879159
"United States","Mississippi","MS",2020-08-09,2020-08-15,7,2020,"33",2976149,860,223,568,292,637,7.49290442111601,9.81133673078868,0.514084507042254
"United States","Mississippi","MS",2020-08-16,2020-08-22,7,2020,"34",2976149,813,155,574,239,658,5.20807257969947,8.03051191321402,0.416376306620209
"United States","Mississippi","MS",2020-08-23,2020-08-29,7,2020,"35",2976149,813,190,572,241,623,6.38408896866387,8.09771284972627,0.421328671328671
"United States","Mississippi","MS",2020-08-30,2020-09-05,7,2020,"36",2976149,736,144,580,156,592,4.83846742888209,5.2416730479556,0.268965517241379
"United States","Mississippi","MS",2020-09-06,2020-09-12,7,2020,"37",2976149,745,112,583,162,633,3.76325244468607,5.44327585749235,0.2778730703259
"United States","Mississippi","MS",2020-09-13,2020-09-19,7,2020,"38",2976149,738,128,587,151,610,4.30085993678408,5.07367070667497,0.257240204429302
"United States","Mississippi","MS",2020-09-20,2020-09-26,7,2020,"39",2976149,723,102,590,133,621,3.42724776212481,4.46886227806471,0.225423728813559
"United States","Mississippi","MS",2020-09-27,2020-10-03,7,2020,"40",2976149,728,104,592,136,624,3.49444869863706,4.56966368283308,0.22972972972973
"United States","Mississippi","MS",2020-10-04,2020-10-10,7,2020,"41",2976149,761,81,595,166,680,2.72163792874617,5.57767773051685,0.278991596638655
"United States","Mississippi","MS",2020-10-11,2020-10-17,7,2020,"42",2976149,680,75,598,82,605,2.52003511920942,2.7552383970023,0.137123745819398
"United States","Mississippi","MS",2020-10-18,2020-10-24,7,2020,"43",2976149,727,84,598,129,643,2.82243933351455,4.3344604050402,0.21571906354515
"United States","Mississippi","MS",2020-10-25,2020-10-31,7,2020,"44",2976149,716,93,608,108,623,3.12484354781968,3.62885057166157,0.177631578947368
"United States","Mississippi","MS",2020-11-01,2020-11-07,7,2020,"45",2976149,750,94,616,134,656,3.15844401607581,4.50246274632083,0.217532467532467
"United States","Mississippi","MS",2020-11-08,2020-11-14,7,2020,"46",2976149,785,98,620,165,687,3.29284588910031,5.54407726226073,0.266129032258065
"United States","Mississippi","MS",2020-11-15,2020-11-21,7,2020,"47",2976149,793,117,631,162,676,3.9312547859667,5.44327585749235,0.256735340729002
"United States","Mississippi","MS",2020-11-22,2020-11-28,7,2020,"48",2976149,820,122,642,178,698,4.09925712724733,5.98088334959036,0.277258566978193
"United States","Mississippi","MS",2020-11-29,2020-12-05,7,2020,"49",2976149,850,170,647,203,680,5.71207960354136,6.8208950559935,0.313755795981453
"United States","Mississippi","MS",2020-12-06,2020-12-12,7,2020,"50",2976149,959,231,655,304,728,7.76170816716502,10.2145423498622,0.46412213740458
"United States","Mississippi","MS",2020-12-13,2020-12-19,7,2020,"51",2976149,923,210,659,264,713,7.05609833378638,8.87052361961716,0.400606980273141
"United States","Mississippi","MS",2020-12-20,2020-12-26,7,2020,"52",2976149,995,175,668,327,820,5.88008194482198,10.9873531197531,0.489520958083832
"United States","Mississippi","MS",2020-12-27,2021-01-02,7,2020,"53",2976149,1068,275,677,391,793,9.24012877043454,13.1377830881451,0.577548005908419
"United States","Mississippi","MS",2021-01-03,2021-01-09,7,2021,"1",2976149,1046,-262,672,374,1308,-8.80332268310491,12.566575127791,0.556547619047619
"United States","Mississippi","MS",2021-01-10,2021-01-16,7,2021,"2",2976149,1057,903,692,365,154,30.3412228352814,12.2641709134858,0.527456647398844
"United States","Mississippi","MS",2021-01-17,2021-01-23,7,2021,"3",2976149,1018,271,688,330,747,9.10572689741004,11.0881545245215,0.479651162790698
"United States","Mississippi","MS",2021-01-24,2021-01-30,7,2021,"4",2976149,920,267,684,236,653,8.97132502438554,7.92971050844565,0.345029239766082
"United States","Mississippi","MS",2021-01-31,2021-02-06,7,2021,"5",2976149,869,247,679,190,622,8.29931565926303,6.38408896866387,0.279823269513991
"United States","Mississippi","MS",2021-02-07,2021-02-13,7,2021,"6",2976149,790,196,678,112,594,6.58569177820062,3.76325244468607,0.165191740412979
"United States","Mississippi","MS",2021-02-14,2021-02-20,7,2021,"7",2976149,807,92,660,147,715,3.09124307956356,4.93926883365047,0.222727272727273
"United States","Mississippi","MS",2021-02-21,2021-02-27,7,2021,"8",2976149,846,116,654,192,730,3.89765431771057,6.45128990517612,0.293577981651376
"United States","Mississippi","MS",2021-02-28,2021-03-06,7,2021,"9",2976149,720,136,650,70,584,4.56966368283308,2.35203277792879,0.107692307692308
"United States","Mississippi","MS",2021-03-07,2021-03-13,7,2021,"10",2976149,752,91,642,110,661,3.05764261130743,3.69605150817382,0.171339563862928
"United States","Mississippi","MS",2021-03-14,2021-03-20,7,2021,"11",2976149,674,60,635,39,614,2.01602809536754,1.3104182619889,0.0614173228346457
"United States","Mississippi","MS",2021-03-21,2021-03-27,7,2021,"12",2976149,672,45,631,41,627,1.51202107152565,1.37761919850115,0.0649762282091917
"United States","Mississippi","MS",2021-03-28,2021-04-03,7,2021,"13",2976149,649,55,626,23,594,1.84802575408691,0.772810769890889,0.0367412140575081
"United States","Mississippi","MS",2021-04-04,2021-04-10,7,2021,"14",2976149,664,38,626,38,626,1.27681779373277,1.27681779373277,0.060702875399361
"United States","Mississippi","MS",2021-04-11,2021-04-17,7,2021,"15",2976149,654,58,622,32,596,1.94882715885529,1.07521498419602,0.0514469453376205
"United States","Mississippi","MS",2021-04-18,2021-04-24,7,2021,"16",2976149,665,22,611,54,643,0.739210301634764,1.81442528583078,0.0883797054009821
"United States","Mississippi","MS",2021-04-25,2021-05-01,7,2021,"17",2976149,693,24,607,86,669,0.806411238147015,2.8896402700268,0.14168039538715
"United States","Mississippi","MS",2021-05-02,2021-05-08,7,2021,"18",2976149,638,29,611,27,609,0.974413579427643,0.907212642915392,0.0441898527004909
"United States","Mississippi","MS",2021-05-09,2021-05-15,7,2021,"19",2976149,632,26,607,25,606,0.873612174659266,0.84001170640314,0.0411861614497528
"United States","Mississippi","MS",2021-05-16,2021-05-22,7,2021,"20",2976149,681,25,599,82,656,0.84001170640314,2.7552383970023,0.136894824707846
"United States","Mississippi","MS",2021-05-23,2021-05-29,7,2021,"21",2976149,689,31,595,94,658,1.04161451593989,3.15844401607581,0.157983193277311
"United States","Mississippi","MS",2021-05-30,2021-06-05,7,2021,"22",2976149,629,15,594,35,614,0.504007023841884,1.1760163889644,0.0589225589225588
"United States","Mississippi","MS",2021-06-06,2021-06-12,7,2021,"23",2976149,706,28,595,111,678,0.940813111171517,3.72965197642994,0.186554621848739
"United States","Mississippi","MS",2021-06-13,2021-06-19,7,2021,"24",2976149,638,18,591,47,620,0.604808428610261,1.5792220080379,0.0795262267343486
"United States","Mississippi","MS",2021-06-20,2021-06-26,7,2021,"25",2976149,639,24,590,49,615,0.806411238147015,1.64642294455016,0.083050847457627
"United States","Mississippi","MS",2021-06-27,2021-07-03,7,2021,"26",2976149,580,24,584,-4,556,0.806411238147015,-0.134401873024502,-0.00684931506849318
"United States","Mississippi","MS",2021-07-04,2021-07-10,7,2021,"27",2976149,609,20,579,30,589,0.672009365122512,1.00801404768377,0.0518134715025906
"United States","Missouri","MO",2019-12-29,2020-01-04,7,2020,"1",6137428,1327,0,1536,-209,1327,0,-3.40533526421817,-0.136067708333333
"United States","Missouri","MO",2020-01-05,2020-01-11,7,2020,"2",6137428,1333,0,1551,-218,1333,0,-3.55197649569168,-0.140554480980013
"United States","Missouri","MO",2020-01-12,2020-01-18,7,2020,"3",6137428,1334,0,1553,-219,1334,0,-3.5682699658554,-0.141017385705087
"United States","Missouri","MO",2020-01-19,2020-01-25,7,2020,"4",6137428,1352,0,1506,-154,1352,0,-2.50919440521339,-0.102257636122178
"United States","Missouri","MO",2020-01-26,2020-02-01,7,2020,"5",6137428,1364,0,1480,-116,1364,0,-1.8900425389919,-0.0783783783783784
"United States","Missouri","MO",2020-02-02,2020-02-08,7,2020,"6",6137428,1334,0,1466,-132,1334,0,-2.15073806161148,-0.0900409276944065
"United States","Missouri","MO",2020-02-09,2020-02-15,7,2020,"7",6137428,1348,0,1437,-89,1348,0,-1.45011884457137,-0.0619345859429367
"United States","Missouri","MO",2020-02-16,2020-02-22,7,2020,"8",6137428,1361,0,1412,-51,1361,0,-0.830966978349889,-0.0361189801699717
"United States","Missouri","MO",2020-02-23,2020-02-29,7,2020,"9",6137428,1370,0,1387,-17,1370,0,-0.276988992783296,-0.0122566690699352
"United States","Missouri","MO",2020-03-01,2020-03-07,7,2020,"10",6137428,1394,0,1375,19,1394,0,0.309575933110743,0.0138181818181817
"United States","Missouri","MO",2020-03-08,2020-03-14,7,2020,"11",6137428,1301,0,1371,-70,1301,0,-1.14054291146063,-0.0510576221735959
"United States","Missouri","MO",2020-03-15,2020-03-21,7,2020,"12",6137428,1272,3,1356,-84,1269,0.0488804104911699,-1.36865149375276,-0.0619469026548672
"United States","Missouri","MO",2020-03-22,2020-03-28,7,2020,"13",6137428,1343,7,1344,-1,1336,0.114054291146063,-0.0162934701637233,-0.000744047619047672
"United States","Missouri","MO",2020-03-29,2020-04-04,7,2020,"14",6137428,1301,13,1322,-21,1288,0.211815112128403,-0.342162873438189,-0.0158850226928896
"United States","Missouri","MO",2020-04-05,2020-04-11,7,2020,"15",6137428,1466,87,1308,158,1379,1.41753190424393,2.57436828586828,0.120795107033639
"United States","Missouri","MO",2020-04-12,2020-04-18,7,2020,"16",6137428,1358,67,1295,63,1291,1.09166250096946,1.02648862031457,0.0486486486486486
"United States","Missouri","MO",2020-04-19,2020-04-25,7,2020,"17",6137428,1448,98,1286,162,1350,1.59676007604488,2.63954216652318,0.12597200622084
"United States","Missouri","MO",2020-04-26,2020-05-02,7,2020,"18",6137428,1393,78,1268,125,1315,1.27089067277042,2.03668377046541,0.0985804416403786
"United States","Missouri","MO",2020-05-03,2020-05-09,7,2020,"19",6137428,1427,121,1245,182,1306,1.97150988981052,2.96541156979764,0.146184738955823
"United States","Missouri","MO",2020-05-10,2020-05-16,7,2020,"20",6137428,1343,116,1229,114,1227,1.8900425389919,1.85745559866446,0.0927583401139138
"United States","Missouri","MO",2020-05-17,2020-05-23,7,2020,"21",6137428,1304,86,1234,70,1218,1.4012384340802,1.14054291146063,0.0567260940032415
"United States","Missouri","MO",2020-05-24,2020-05-30,7,2020,"22",6137428,1244,94,1230,14,1150,1.53158619538999,0.228108582292126,0.0113821138211383
"United States","Missouri","MO",2020-05-31,2020-06-06,7,2020,"23",6137428,1293,37,1222,71,1256,0.602858396057762,1.15683638162435,0.0581014729950899
"United States","Missouri","MO",2020-06-07,2020-06-13,7,2020,"24",6137428,1263,70,1217,46,1193,1.14054291146063,0.749499627531272,0.0377978635990139
"United States","Missouri","MO",2020-06-14,2020-06-20,7,2020,"25",6137428,1228,78,1221,7,1150,1.27089067277042,0.114054291146063,0.00573300573300584
"United States","Missouri","MO",2020-06-21,2020-06-27,7,2020,"26",6137428,1284,41,1213,71,1243,0.668032276712656,1.15683638162435,0.0585325638911789
"United States","Missouri","MO",2020-06-28,2020-07-04,7,2020,"27",6137428,1284,26,1216,68,1258,0.423630224256806,1.10795597113318,0.055921052631579
"United States","Missouri","MO",2020-07-05,2020-07-11,7,2020,"28",6137428,1295,47,1215,80,1248,0.765793097694995,1.30347761309786,0.0658436213991769
"United States","Missouri","MO",2020-07-12,2020-07-18,7,2020,"29",6137428,1367,61,1202,165,1306,0.993901679987122,2.68842257701435,0.137271214642263
"United States","Missouri","MO",2020-07-19,2020-07-25,7,2020,"30",6137428,1355,52,1190,165,1303,0.847260448513612,2.68842257701435,0.138655462184874
"United States","Missouri","MO",2020-07-26,2020-08-01,7,2020,"31",6137428,1366,71,1201,165,1295,1.15683638162435,2.68842257701435,0.137385512073272
"United States","Missouri","MO",2020-08-02,2020-08-08,7,2020,"32",6137428,1355,48,1195,160,1307,0.782086567858719,2.60695522619573,0.133891213389121
"United States","Missouri","MO",2020-08-09,2020-08-15,7,2020,"33",6137428,1380,45,1192,188,1335,0.733206157367549,3.06317239077998,0.157718120805369
"United States","Missouri","MO",2020-08-16,2020-08-22,7,2020,"34",6137428,1402,79,1183,219,1323,1.28718414293414,3.5682699658554,0.185122569737954
"United States","Missouri","MO",2020-08-23,2020-08-29,7,2020,"35",6137428,1382,71,1176,206,1311,1.15683638162435,3.356454853727,0.175170068027211
"United States","Missouri","MO",2020-08-30,2020-09-05,7,2020,"36",6137428,1410,143,1168,242,1267,2.32996623341243,3.94301977962104,0.207191780821918
"United States","Missouri","MO",2020-09-06,2020-09-12,7,2020,"37",6137428,1369,65,1171,198,1304,1.05907556064201,3.22610709241721,0.169086251067464
"United States","Missouri","MO",2020-09-13,2020-09-19,7,2020,"38",6137428,1445,89,1167,278,1356,1.45011884457137,4.52958470551508,0.2382176520994
"United States","Missouri","MO",2020-09-20,2020-09-26,7,2020,"39",6137428,1465,270,1163,302,1195,4.39923694420529,4.92062798944444,0.259673258813414
"United States","Missouri","MO",2020-09-27,2020-10-03,7,2020,"40",6137428,1522,107,1165,357,1415,1.74340130751839,5.81676884844922,0.306437768240343
"United States","Missouri","MO",2020-10-04,2020-10-10,7,2020,"41",6137428,1531,253,1175,356,1278,4.122247951422,5.8004753782855,0.302978723404255
"United States","Missouri","MO",2020-10-11,2020-10-17,7,2020,"42",6137428,1519,162,1188,331,1357,2.63954216652318,5.39313862419241,0.278619528619529
"United States","Missouri","MO",2020-10-18,2020-10-24,7,2020,"43",6137428,1577,253,1195,382,1324,4.122247951422,6.2241056025423,0.319665271966527
"United States","Missouri","MO",2020-10-25,2020-10-31,7,2020,"44",6137428,1611,221,1200,411,1390,3.60085690618285,6.69661623729028,0.3425
"United States","Missouri","MO",2020-11-01,2020-11-07,7,2020,"45",6137428,1790,94,1211,579,1696,1.53158619538999,9.43391922479579,0.478117258464079
"United States","Missouri","MO",2020-11-08,2020-11-14,7,2020,"46",6137428,1839,219,1201,638,1620,3.5682699658554,10.3952339644555,0.531223980016653
"United States","Missouri","MO",2020-11-15,2020-11-21,7,2020,"47",6137428,1858,180,1203,655,1678,2.9328246294702,10.6722229572388,0.544472152950956
"United States","Missouri","MO",2020-11-22,2020-11-28,7,2020,"48",6137428,1908,269,1212,696,1639,4.38294347404157,11.3402552339514,0.574257425742574
"United States","Missouri","MO",2020-11-29,2020-12-05,7,2020,"49",6137428,1962,360,1224,738,1602,5.86564925894039,12.0245809808278,0.602941176470588
"United States","Missouri","MO",2020-12-06,2020-12-12,7,2020,"50",6137428,2017,329,1245,772,1688,5.36055168386497,12.5785589663944,0.62008032128514
"United States","Missouri","MO",2020-12-13,2020-12-19,7,2020,"51",6137428,1890,427,1278,612,1463,6.95731175990985,9.97160374019866,0.47887323943662
"United States","Missouri","MO",2020-12-20,2020-12-26,7,2020,"52",6137428,1830,357,1303,527,1473,5.81676884844922,8.58665877628218,0.404451266308519
"United States","Missouri","MO",2020-12-27,2021-01-02,7,2020,"53",6137428,1837,249,1321,516,1588,4.0570740707671,8.40743060448123,0.390613171839516
"United States","Missouri","MO",2021-01-03,2021-01-09,7,2021,"1",6137428,1749,401,1335,414,1348,6.53368153565305,6.74549664778145,0.310112359550562
"United States","Missouri","MO",2021-01-10,2021-01-16,7,2021,"2",6137428,1783,306,1361,422,1477,4.98580187009933,6.87584440909124,0.310066127847171
"United States","Missouri","MO",2021-01-17,2021-01-23,7,2021,"3",6137428,1721,291,1399,322,1430,4.74139981764348,5.2464973927189,0.230164403145104
"United States","Missouri","MO",2021-01-24,2021-01-30,7,2021,"4",6137428,1626,207,1383,243,1419,3.37274832389072,3.95931324978476,0.175704989154013
"United States","Missouri","MO",2021-01-31,2021-02-06,7,2021,"5",6137428,1532,394,1396,136,1138,6.41962724450698,2.21591194226637,0.0974212034383954
"United States","Missouri","MO",2021-02-07,2021-02-13,7,2021,"6",6137428,1434,311,1394,40,1123,5.06726922091795,0.651738806548932,0.0286944045911048
"United States","Missouri","MO",2021-02-14,2021-02-20,7,2021,"7",6137428,1524,268,1367,157,1256,4.36665000387785,2.55807481570456,0.114850036576445
"United States","Missouri","MO",2021-02-21,2021-02-27,7,2021,"8",6137428,1409,199,1352,57,1210,3.24240056258094,0.928727799332228,0.0421597633136095
"United States","Missouri","MO",2021-02-28,2021-03-06,7,2021,"9",6137428,1377,248,1340,37,1129,4.04078060060338,0.602858396057762,0.0276119402985076
"United States","Missouri","MO",2021-03-07,2021-03-13,7,2021,"10",6137428,1323,149,1339,-16,1174,2.42772705439477,-0.260695522619573,-0.011949215832711
"United States","Missouri","MO",2021-03-14,2021-03-20,7,2021,"11",6137428,1259,63,1324,-65,1196,1.02648862031457,-1.05907556064201,-0.0490936555891238
"United States","Missouri","MO",2021-03-21,2021-03-27,7,2021,"12",6137428,1402,74,1306,96,1328,1.20571679211552,1.56417313571744,0.0735068912710566
"United States","Missouri","MO",2021-03-28,2021-04-03,7,2021,"13",6137428,1297,61,1274,23,1236,0.993901679987122,0.374749813765636,0.0180533751962324
"United States","Missouri","MO",2021-04-04,2021-04-10,7,2021,"14",6137428,1396,0,1268,128,1396,0,2.08556418095658,0.100946372239748
"United States","Missouri","MO",2021-04-11,2021-04-17,7,2021,"15",6137428,1311,120,1258,53,1191,1.9552164196468,0.863553918677335,0.0421303656597773
"United States","Missouri","MO",2021-04-18,2021-04-24,7,2021,"16",6137428,1301,60,1258,43,1241,0.977608209823398,0.700619217040102,0.034181240063593
"United States","Missouri","MO",2021-04-25,2021-05-01,7,2021,"17",6137428,1311,50,1253,58,1261,0.814673508186165,0.945021269495952,0.0462889066241021
"United States","Missouri","MO",2021-05-02,2021-05-08,7,2021,"18",6137428,1243,78,1233,10,1165,1.27089067277042,0.162934701637233,0.00811030008110292
"United States","Missouri","MO",2021-05-09,2021-05-15,7,2021,"19",6137428,1317,36,1218,99,1281,0.586564925894039,1.61305354620861,0.0812807881773399
"United States","Missouri","MO",2021-05-16,2021-05-22,7,2021,"20",6137428,1262,147,1205,57,1115,2.39514011406733,0.928727799332228,0.0473029045643154
"United States","Missouri","MO",2021-05-23,2021-05-29,7,2021,"21",6137428,1230,74,1206,24,1156,1.20571679211552,0.391043283929359,0.0199004975124377
"United States","Missouri","MO",2021-05-30,2021-06-05,7,2021,"22",6137428,1300,60,1191,109,1240,0.977608209823398,1.77598824784584,0.0915197313182199
"United States","Missouri","MO",2021-06-06,2021-06-12,7,2021,"23",6137428,1304,56,1193,111,1248,0.912434329168505,1.80857518817329,0.0930427493713328
"United States","Missouri","MO",2021-06-13,2021-06-19,7,2021,"24",6137428,1268,34,1203,65,1234,0.553977985566592,1.05907556064201,0.0540315876974231
"United States","Missouri","MO",2021-06-20,2021-06-26,7,2021,"25",6137428,1330,27,1212,118,1303,0.439923694420529,1.92262947931935,0.0973597359735974
"United States","Missouri","MO",2021-06-27,2021-07-03,7,2021,"26",6137428,1170,82,1198,-28,1088,1.33606455342531,-0.456217164584253,-0.0233722871452421
"United States","Missouri","MO",2021-07-04,2021-07-10,7,2021,"27",6137428,1157,48,1197,-40,1109,0.782086567858719,-0.651738806548932,-0.0334168755221387
"United States","Montana","MT",2019-12-29,2020-01-04,7,2020,"1",1068778,231,0,203,28,231,0,2.61981440486238,0.137931034482759
"United States","Montana","MT",2020-01-05,2020-01-11,7,2020,"2",1068778,211,0,203,8,211,0,0.74851840138925,0.0394088669950738
"United States","Montana","MT",2020-01-12,2020-01-18,7,2020,"3",1068778,202,0,202,0,202,0,0,0
"United States","Montana","MT",2020-01-19,2020-01-25,7,2020,"4",1068778,197,0,201,-4,197,0,-0.374259200694625,-0.0199004975124378
"United States","Montana","MT",2020-01-26,2020-02-01,7,2020,"5",1068778,218,0,202,16,218,0,1.4970368027785,0.0792079207920793
"United States","Montana","MT",2020-02-02,2020-02-08,7,2020,"6",1068778,202,0,203,-1,202,0,-0.0935648001736563,-0.00492610837438423
"United States","Montana","MT",2020-02-09,2020-02-15,7,2020,"7",1068778,198,0,200,-2,198,0,-0.187129600347313,-0.01
"United States","Montana","MT",2020-02-16,2020-02-22,7,2020,"8",1068778,217,0,204,13,217,0,1.21634240225753,0.0637254901960784
"United States","Montana","MT",2020-02-23,2020-02-29,7,2020,"9",1068778,236,0,203,33,236,0,3.08763840573066,0.16256157635468
"United States","Montana","MT",2020-03-01,2020-03-07,7,2020,"10",1068778,221,0,198,23,221,0,2.15199040399409,0.116161616161616
"United States","Montana","MT",2020-03-08,2020-03-14,7,2020,"11",1068778,218,0,193,25,218,0,2.33912000434141,0.129533678756477
"United States","Montana","MT",2020-03-15,2020-03-21,7,2020,"12",1068778,229,0,195,34,229,0,3.18120320590431,0.174358974358974
"United States","Montana","MT",2020-03-22,2020-03-28,7,2020,"13",1068778,205,1,190,15,204,0.0935648001736563,1.40347200260484,0.0789473684210527
"United States","Montana","MT",2020-03-29,2020-04-04,7,2020,"14",1068778,177,4,189,-12,173,0.374259200694625,-1.12277760208388,-0.0634920634920635
"United States","Montana","MT",2020-04-05,2020-04-11,7,2020,"15",1068778,216,1,190,26,215,0.0935648001736563,2.43268480451506,0.136842105263158
"United States","Montana","MT",2020-04-12,2020-04-18,7,2020,"16",1068778,191,6,188,3,185,0.561388801041938,0.280694400520969,0.0159574468085106
"United States","Montana","MT",2020-04-19,2020-04-25,7,2020,"17",1068778,187,4,183,4,183,0.374259200694625,0.374259200694625,0.0218579234972678
"United States","Montana","MT",2020-04-26,2020-05-02,7,2020,"18",1068778,204,2,184,20,202,0.187129600347313,1.87129600347313,0.108695652173913
"United States","Montana","MT",2020-05-03,2020-05-09,7,2020,"19",1068778,177,0,180,-3,177,0,-0.280694400520969,-0.0166666666666667
"United States","Montana","MT",2020-05-10,2020-05-16,7,2020,"20",1068778,205,0,179,26,205,0,2.43268480451506,0.145251396648045
"United States","Montana","MT",2020-05-17,2020-05-23,7,2020,"21",1068778,181,0,179,2,181,0,0.187129600347313,0.011173184357542
"United States","Montana","MT",2020-05-24,2020-05-30,7,2020,"22",1068778,180,1,181,-1,179,0.0935648001736563,-0.0935648001736563,-0.00552486187845302
"United States","Montana","MT",2020-05-31,2020-06-06,7,2020,"23",1068778,178,1,180,-2,177,0.0935648001736563,-0.187129600347313,-0.0111111111111111
"United States","Montana","MT",2020-06-07,2020-06-13,7,2020,"24",1068778,223,0,181,42,223,0,3.92972160729356,0.232044198895028
"United States","Montana","MT",2020-06-14,2020-06-20,7,2020,"25",1068778,198,2,180,18,196,0.187129600347313,1.68416640312581,0.1
"United States","Montana","MT",2020-06-21,2020-06-27,7,2020,"26",1068778,199,2,183,16,197,0.187129600347313,1.4970368027785,0.0874316939890711
"United States","Montana","MT",2020-06-28,2020-07-04,7,2020,"27",1068778,175,1,181,-6,174,0.0935648001736563,-0.561388801041938,-0.0331491712707183
"United States","Montana","MT",2020-07-05,2020-07-11,7,2020,"28",1068778,190,6,184,6,184,0.561388801041938,0.561388801041938,0.0326086956521738
"United States","Montana","MT",2020-07-12,2020-07-18,7,2020,"29",1068778,203,8,188,15,195,0.74851840138925,1.40347200260484,0.0797872340425532
"United States","Montana","MT",2020-07-19,2020-07-25,7,2020,"30",1068778,224,9,191,33,215,0.842083201562906,3.08763840573066,0.172774869109948
"United States","Montana","MT",2020-07-26,2020-08-01,7,2020,"31",1068778,216,15,191,25,201,1.40347200260484,2.33912000434141,0.130890052356021
"United States","Montana","MT",2020-08-02,2020-08-08,7,2020,"32",1068778,216,14,191,25,202,1.30990720243119,2.33912000434141,0.130890052356021
"United States","Montana","MT",2020-08-09,2020-08-15,7,2020,"33",1068778,204,7,188,16,197,0.654953601215594,1.4970368027785,0.0851063829787233
"United States","Montana","MT",2020-08-16,2020-08-22,7,2020,"34",1068778,240,8,184,56,232,0.74851840138925,5.23962880972475,0.304347826086957
"United States","Montana","MT",2020-08-23,2020-08-29,7,2020,"35",1068778,195,14,182,13,181,1.30990720243119,1.21634240225753,0.0714285714285714
"United States","Montana","MT",2020-08-30,2020-09-05,7,2020,"36",1068778,233,12,180,53,221,1.12277760208388,4.95893440920378,0.294444444444445
"United States","Montana","MT",2020-09-06,2020-09-12,7,2020,"37",1068778,221,17,177,44,204,1.59060160295216,4.11685120764088,0.248587570621469
"United States","Montana","MT",2020-09-13,2020-09-19,7,2020,"38",1068778,235,23,179,56,212,2.15199040399409,5.23962880972475,0.312849162011173
"United States","Montana","MT",2020-09-20,2020-09-26,7,2020,"39",1068778,236,15,183,53,221,1.40347200260484,4.95893440920378,0.289617486338798
"United States","Montana","MT",2020-09-27,2020-10-03,7,2020,"40",1068778,240,15,185,55,225,1.40347200260484,5.14606400955109,0.297297297297297
"United States","Montana","MT",2020-10-04,2020-10-10,7,2020,"41",1068778,282,23,189,93,259,2.15199040399409,8.70152641615003,0.492063492063492
"United States","Montana","MT",2020-10-11,2020-10-17,7,2020,"42",1068778,267,31,192,75,236,2.90050880538334,7.01736001302422,0.390625
"United States","Montana","MT",2020-10-18,2020-10-24,7,2020,"43",1068778,295,54,192,103,241,5.05249920937744,9.63717441788659,0.536458333333333
"United States","Montana","MT",2020-10-25,2020-10-31,7,2020,"44",1068778,317,81,189,128,236,7.57874881406616,11.976294422228,0.677248677248677
"United States","Montana","MT",2020-11-01,2020-11-07,7,2020,"45",1068778,299,70,191,108,229,6.54953601215594,10.1049984187549,0.56544502617801
"United States","Montana","MT",2020-11-08,2020-11-14,7,2020,"46",1068778,323,66,193,130,257,6.17527681146131,12.1634240225753,0.673575129533679
"United States","Montana","MT",2020-11-15,2020-11-21,7,2020,"47",1068778,332,87,192,140,245,8.1401376151081,13.0990720243119,0.729166666666667
"United States","Montana","MT",2020-11-22,2020-11-28,7,2020,"48",1068778,307,71,190,117,236,6.6431008123296,10.9470816203178,0.61578947368421
"United States","Montana","MT",2020-11-29,2020-12-05,7,2020,"49",1068778,270,64,192,78,206,5.988147211114,7.29805441354519,0.40625
"United States","Montana","MT",2020-12-06,2020-12-12,7,2020,"50",1068778,303,83,192,111,220,7.76587841441347,10.3856928192758,0.578125
"United States","Montana","MT",2020-12-13,2020-12-19,7,2020,"51",1068778,271,48,196,75,223,4.4911104083355,7.01736001302422,0.38265306122449
"United States","Montana","MT",2020-12-20,2020-12-26,7,2020,"52",1068778,308,55,199,109,253,5.14606400955109,10.1985632189285,0.547738693467337
"United States","Montana","MT",2020-12-27,2021-01-02,7,2020,"53",1068778,274,52,206,68,222,4.86536960903013,6.36240641180863,0.330097087378641
"United States","Montana","MT",2021-01-03,2021-01-09,7,2021,"1",1068778,248,82,208,40,166,7.67231361423981,3.74259200694625,0.192307692307692
"United States","Montana","MT",2021-01-10,2021-01-16,7,2021,"2",1068778,253,35,211,42,218,3.27476800607797,3.92972160729356,0.199052132701422
"United States","Montana","MT",2021-01-17,2021-01-23,7,2021,"3",1068778,247,53,212,35,194,4.95893440920378,3.27476800607797,0.165094339622641
"United States","Montana","MT",2021-01-24,2021-01-30,7,2021,"4",1068778,202,91,215,-13,111,8.51439681580272,-1.21634240225753,-0.0604651162790698
"United States","Montana","MT",2021-01-31,2021-02-06,7,2021,"5",1068778,219,78,217,2,141,7.29805441354519,0.187129600347313,0.00921658986175111
"United States","Montana","MT",2021-02-07,2021-02-13,7,2021,"6",1068778,225,17,221,4,208,1.59060160295216,0.374259200694625,0.0180995475113122
"United States","Montana","MT",2021-02-14,2021-02-20,7,2021,"7",1068778,213,12,222,-9,201,1.12277760208388,-0.842083201562906,-0.0405405405405406
"United States","Montana","MT",2021-02-21,2021-02-27,7,2021,"8",1068778,227,16,224,3,211,1.4970368027785,0.280694400520969,0.0133928571428572
"United States","Montana","MT",2021-02-28,2021-03-06,7,2021,"9",1068778,191,24,222,-31,167,2.24555520416775,-2.90050880538334,-0.13963963963964
"United States","Montana","MT",2021-03-07,2021-03-13,7,2021,"10",1068778,202,12,216,-14,190,1.12277760208388,-1.30990720243119,-0.0648148148148148
"United States","Montana","MT",2021-03-14,2021-03-20,7,2021,"11",1068778,224,22,212,12,202,2.05842560382044,1.12277760208388,0.0566037735849056
"United States","Montana","MT",2021-03-21,2021-03-27,7,2021,"12",1068778,208,22,209,-1,186,2.05842560382044,-0.0935648001736563,-0.00478468899521534
"United States","Montana","MT",2021-03-28,2021-04-03,7,2021,"13",1068778,170,29,209,-39,141,2.71337920503603,-3.64902720677259,-0.186602870813397
"United States","Montana","MT",2021-04-04,2021-04-10,7,2021,"14",1068778,207,57,205,2,150,5.33319360989841,0.187129600347313,0.00975609756097562
"United States","Montana","MT",2021-04-11,2021-04-17,7,2021,"15",1068778,236,22,206,30,214,2.05842560382044,2.80694400520969,0.145631067961165
"United States","Montana","MT",2021-04-18,2021-04-24,7,2021,"16",1068778,208,18,206,2,190,1.68416640312581,0.187129600347313,0.00970873786407767
"United States","Montana","MT",2021-04-25,2021-05-01,7,2021,"17",1068778,227,11,205,22,216,1.02921280191022,2.05842560382044,0.107317073170732
"United States","Montana","MT",2021-05-02,2021-05-08,7,2021,"18",1068778,200,18,201,-1,182,1.68416640312581,-0.0935648001736563,-0.00497512437810943
"United States","Montana","MT",2021-05-09,2021-05-15,7,2021,"19",1068778,199,6,200,-1,193,0.561388801041938,-0.0935648001736563,-0.005
"United States","Montana","MT",2021-05-16,2021-05-22,7,2021,"20",1068778,227,5,197,30,222,0.467824000868281,2.80694400520969,0.152284263959391
"United States","Montana","MT",2021-05-23,2021-05-29,7,2021,"21",1068778,215,10,198,17,205,0.935648001736563,1.59060160295216,0.0858585858585859
"United States","Montana","MT",2021-05-30,2021-06-05,7,2021,"22",1068778,204,19,198,6,185,1.77773120329947,0.561388801041938,0.0303030303030303
"United States","Montana","MT",2021-06-06,2021-06-12,7,2021,"23",1068778,233,9,200,33,224,0.842083201562906,3.08763840573066,0.165
"United States","Montana","MT",2021-06-13,2021-06-19,7,2021,"24",1068778,237,10,199,38,227,0.935648001736563,3.55546240659894,0.190954773869347
"United States","Montana","MT",2021-06-20,2021-06-26,7,2021,"25",1068778,214,11,201,13,203,1.02921280191022,1.21634240225753,0.0646766169154229
"United States","Montana","MT",2021-06-27,2021-07-03,7,2021,"26",1068778,225,4,202,23,221,0.374259200694625,2.15199040399409,0.113861386138614
"United States","Montana","MT",2021-07-04,2021-07-10,7,2021,"27",1068778,159,7,206,-47,152,0.654953601215594,-4.39754560816184,-0.228155339805825
"United States","Nebraska","NE",2019-12-29,2020-01-04,7,2020,"1",1934408,346,0,397,-51,346,0,-2.63646552330222,-0.128463476070529
"United States","Nebraska","NE",2020-01-05,2020-01-11,7,2020,"2",1934408,362,0,396,-34,362,0,-1.75764368220148,-0.0858585858585859
"United States","Nebraska","NE",2020-01-12,2020-01-18,7,2020,"3",1934408,333,0,395,-62,333,0,-3.20511494989682,-0.156962025316456
"United States","Nebraska","NE",2020-01-19,2020-01-25,7,2020,"4",1934408,358,0,382,-24,358,0,-1.24068965802457,-0.06282722513089
"United States","Nebraska","NE",2020-01-26,2020-02-01,7,2020,"5",1934408,373,0,378,-5,373,0,-0.258477012088453,-0.0132275132275133
"United States","Nebraska","NE",2020-02-02,2020-02-08,7,2020,"6",1934408,345,0,372,-27,345,0,-1.39577586527765,-0.0725806451612904
"United States","Nebraska","NE",2020-02-09,2020-02-15,7,2020,"7",1934408,327,0,364,-37,327,0,-1.91272988945455,-0.101648351648352
"United States","Nebraska","NE",2020-02-16,2020-02-22,7,2020,"8",1934408,318,0,359,-41,318,0,-2.11951149912531,-0.114206128133705
"United States","Nebraska","NE",2020-02-23,2020-02-29,7,2020,"9",1934408,341,0,360,-19,341,0,-0.982212645936121,-0.0527777777777778
"United States","Nebraska","NE",2020-03-01,2020-03-07,7,2020,"10",1934408,355,0,360,-5,355,0,-0.258477012088453,-0.0138888888888888
"United States","Nebraska","NE",2020-03-08,2020-03-14,7,2020,"11",1934408,343,0,354,-11,343,0,-0.568649426594596,-0.0310734463276836
"United States","Nebraska","NE",2020-03-15,2020-03-21,7,2020,"12",1934408,350,0,358,-8,350,0,-0.413563219341525,-0.0223463687150838
"United States","Nebraska","NE",2020-03-22,2020-03-28,7,2020,"13",1934408,331,2,356,-25,329,0.103390804835381,-1.29238506044226,-0.0702247191011236
"United States","Nebraska","NE",2020-03-29,2020-04-04,7,2020,"14",1934408,310,4,351,-41,306,0.206781609670762,-2.11951149912531,-0.116809116809117
"United States","Nebraska","NE",2020-04-05,2020-04-11,7,2020,"15",1934408,343,8,342,1,335,0.413563219341525,0.0516954024176906,0.00292397660818722
"United States","Nebraska","NE",2020-04-12,2020-04-18,7,2020,"16",1934408,353,0,341,12,353,0,0.620344829012287,0.0351906158357771
"United States","Nebraska","NE",2020-04-19,2020-04-25,7,2020,"17",1934408,353,0,335,18,353,0,0.93051724351843,0.0537313432835822
"United States","Nebraska","NE",2020-04-26,2020-05-02,7,2020,"18",1934408,344,64,331,13,280,3.3085057547322,0.672040231429978,0.0392749244712991
"United States","Nebraska","NE",2020-05-03,2020-05-09,7,2020,"19",1934408,338,18,326,12,320,0.93051724351843,0.620344829012287,0.0368098159509203
"United States","Nebraska","NE",2020-05-10,2020-05-16,7,2020,"20",1934408,352,26,329,23,326,1.34408046285996,1.18899425560688,0.0699088145896656
"United States","Nebraska","NE",2020-05-17,2020-05-23,7,2020,"21",1934408,347,23,326,21,324,1.18899425560688,1.0856034507715,0.0644171779141105
"United States","Nebraska","NE",2020-05-24,2020-05-30,7,2020,"22",1934408,375,21,326,49,354,1.0856034507715,2.53307471846684,0.150306748466258
"United States","Nebraska","NE",2020-05-31,2020-06-06,7,2020,"23",1934408,319,21,324,-5,298,1.0856034507715,-0.258477012088453,-0.0154320987654321
"United States","Nebraska","NE",2020-06-07,2020-06-13,7,2020,"24",1934408,319,29,331,-12,290,1.49916667011303,-0.620344829012287,-0.0362537764350453
"United States","Nebraska","NE",2020-06-14,2020-06-20,7,2020,"25",1934408,371,28,328,43,343,1.44747126769534,2.22290230396069,0.13109756097561
"United States","Nebraska","NE",2020-06-21,2020-06-27,7,2020,"26",1934408,320,23,325,-5,297,1.18899425560688,-0.258477012088453,-0.0153846153846153
"United States","Nebraska","NE",2020-06-28,2020-07-04,7,2020,"27",1934408,308,17,319,-11,291,0.87882184110074,-0.568649426594596,-0.0344827586206896
"United States","Nebraska","NE",2020-07-05,2020-07-11,7,2020,"28",1934408,317,1,317,0,316,0.0516954024176906,0,0
"United States","Nebraska","NE",2020-07-12,2020-07-18,7,2020,"29",1934408,325,15,308,17,310,0.775431036265359,0.87882184110074,0.0551948051948052
"United States","Nebraska","NE",2020-07-19,2020-07-25,7,2020,"30",1934408,361,17,304,57,344,0.87882184110074,2.94663793780836,0.1875
"United States","Nebraska","NE",2020-07-26,2020-08-01,7,2020,"31",1934408,358,16,302,56,342,0.827126438683049,2.89494253539067,0.185430463576159
"United States","Nebraska","NE",2020-08-02,2020-08-08,7,2020,"32",1934408,381,13,306,75,368,0.672040231429978,3.87715518132679,0.245098039215686
"United States","Nebraska","NE",2020-08-09,2020-08-15,7,2020,"33",1934408,354,16,309,45,338,0.827126438683049,2.32629310879608,0.145631067961165
"United States","Nebraska","NE",2020-08-16,2020-08-22,7,2020,"34",1934408,363,15,311,52,348,0.775431036265359,2.68816092571991,0.167202572347267
"United States","Nebraska","NE",2020-08-23,2020-08-29,7,2020,"35",1934408,323,15,310,13,308,0.775431036265359,0.672040231429978,0.0419354838709678
"United States","Nebraska","NE",2020-08-30,2020-09-05,7,2020,"36",1934408,350,12,314,36,338,0.620344829012287,1.86103448703686,0.114649681528662
"United States","Nebraska","NE",2020-09-06,2020-09-12,7,2020,"37",1934408,339,31,313,26,308,1.60255747494841,1.34408046285996,0.0830670926517572
"United States","Nebraska","NE",2020-09-13,2020-09-19,7,2020,"38",1934408,328,8,313,15,320,0.413563219341525,0.775431036265359,0.0479233226837061
"United States","Nebraska","NE",2020-09-20,2020-09-26,7,2020,"39",1934408,378,27,315,63,351,1.39577586527765,3.25681035231451,0.2
"United States","Nebraska","NE",2020-09-27,2020-10-03,7,2020,"40",1934408,373,28,317,56,345,1.44747126769534,2.89494253539067,0.176656151419558
"United States","Nebraska","NE",2020-10-04,2020-10-10,7,2020,"41",1934408,406,21,318,88,385,1.0856034507715,4.54919541275677,0.276729559748428
"United States","Nebraska","NE",2020-10-11,2020-10-17,7,2020,"42",1934408,401,29,317,84,372,1.49916667011303,4.34241380308601,0.264984227129337
"United States","Nebraska","NE",2020-10-18,2020-10-24,7,2020,"43",1934408,425,48,323,102,377,2.48137931604915,5.27293104660444,0.315789473684211
"United States","Nebraska","NE",2020-10-25,2020-10-31,7,2020,"44",1934408,442,49,326,116,393,2.53307471846684,5.99666668045211,0.355828220858896
"United States","Nebraska","NE",2020-11-01,2020-11-07,7,2020,"45",1934408,498,56,321,177,442,2.89494253539067,9.15008622793123,0.551401869158878
"United States","Nebraska","NE",2020-11-08,2020-11-14,7,2020,"46",1934408,551,77,321,230,474,3.98054598616217,11.8899425560688,0.716510903426791
"United States","Nebraska","NE",2020-11-15,2020-11-21,7,2020,"47",1934408,574,122,325,249,452,6.30683909495825,12.872155202005,0.766153846153846
"United States","Nebraska","NE",2020-11-22,2020-11-28,7,2020,"48",1934408,565,81,326,239,484,4.18732759583294,12.3552011778281,0.733128834355828
"United States","Nebraska","NE",2020-11-29,2020-12-05,7,2020,"49",1934408,514,211,329,185,303,10.9077299101327,9.56364944727276,0.562310030395137
"United States","Nebraska","NE",2020-12-06,2020-12-12,7,2020,"50",1934408,501,171,339,162,330,8.83991381342509,8.37465519166587,0.47787610619469
"United States","Nebraska","NE",2020-12-13,2020-12-19,7,2020,"51",1934408,460,110,343,117,350,5.68649426594596,6.0483620828698,0.341107871720117
"United States","Nebraska","NE",2020-12-20,2020-12-26,7,2020,"52",1934408,426,81,362,64,345,4.18732759583294,3.3085057547322,0.176795580110497
"United States","Nebraska","NE",2020-12-27,2021-01-02,7,2020,"53",1934408,434,111,367,67,323,5.73818966836365,3.46359196198527,0.182561307901907
"United States","Nebraska","NE",2021-01-03,2021-01-09,7,2021,"1",1934408,447,71,373,74,376,3.67037357165603,3.8254597789091,0.198391420911528
"United States","Nebraska","NE",2021-01-10,2021-01-16,7,2021,"2",1934408,390,87,375,15,303,4.49750001033908,0.775431036265359,0.04
"United States","Nebraska","NE",2021-01-17,2021-01-23,7,2021,"3",1934408,407,50,369,38,357,2.58477012088453,1.96442529187224,0.102981029810298
"United States","Nebraska","NE",2021-01-24,2021-01-30,7,2021,"4",1934408,383,40,360,23,343,2.06781609670762,1.18899425560688,0.0638888888888889
"United States","Nebraska","NE",2021-01-31,2021-02-06,7,2021,"5",1934408,369,46,358,11,323,2.37798851121377,0.568649426594596,0.0307262569832403
"United States","Nebraska","NE",2021-02-07,2021-02-13,7,2021,"6",1934408,345,43,354,-9,302,2.22290230396069,-0.465258621759215,-0.0254237288135594
"United States","Nebraska","NE",2021-02-14,2021-02-20,7,2021,"7",1934408,332,44,351,-19,288,2.27459770637839,-0.982212645936121,-0.0541310541310541
"United States","Nebraska","NE",2021-02-21,2021-02-27,7,2021,"8",1934408,322,31,351,-29,291,1.60255747494841,-1.49916667011303,-0.0826210826210826
"United States","Nebraska","NE",2021-02-28,2021-03-06,7,2021,"9",1934408,358,31,355,3,327,1.60255747494841,0.155086207253072,0.0084507042253521
"United States","Nebraska","NE",2021-03-07,2021-03-13,7,2021,"10",1934408,322,19,348,-26,303,0.982212645936121,-1.34408046285996,-0.0747126436781609
"United States","Nebraska","NE",2021-03-14,2021-03-20,7,2021,"11",1934408,332,9,347,-15,323,0.465258621759215,-0.775431036265359,-0.0432276657060519
"United States","Nebraska","NE",2021-03-21,2021-03-27,7,2021,"12",1934408,337,38,343,-6,299,1.96442529187224,-0.310172414506144,-0.0174927113702624
"United States","Nebraska","NE",2021-03-28,2021-04-03,7,2021,"13",1934408,333,12,342,-9,321,0.620344829012287,-0.465258621759215,-0.0263157894736842
"United States","Nebraska","NE",2021-04-04,2021-04-10,7,2021,"14",1934408,325,27,335,-10,298,1.39577586527765,-0.516954024176906,-0.0298507462686567
"United States","Nebraska","NE",2021-04-11,2021-04-17,7,2021,"15",1934408,366,-7,331,35,373,-0.361867816923834,1.80933908461917,0.105740181268882
"United States","Nebraska","NE",2021-04-18,2021-04-24,7,2021,"16",1934408,331,29,325,6,302,1.49916667011303,0.310172414506144,0.0184615384615385
"United States","Nebraska","NE",2021-04-25,2021-05-01,7,2021,"17",1934408,373,3,323,50,370,0.155086207253072,2.58477012088453,0.154798761609907
"United States","Nebraska","NE",2021-05-02,2021-05-08,7,2021,"18",1934408,345,7,318,27,338,0.361867816923834,1.39577586527765,0.0849056603773586
"United States","Nebraska","NE",2021-05-09,2021-05-15,7,2021,"19",1934408,374,33,316,58,341,1.70594827978379,2.99833334022605,0.183544303797468
"United States","Nebraska","NE",2021-05-16,2021-05-22,7,2021,"20",1934408,323,-36,318,5,359,-1.86103448703686,0.258477012088453,0.0157232704402517
"United States","Nebraska","NE",2021-05-23,2021-05-29,7,2021,"21",1934408,329,-12,313,16,341,-0.620344829012287,0.827126438683049,0.0511182108626198
"United States","Nebraska","NE",2021-05-30,2021-06-05,7,2021,"22",1934408,308,0,311,-3,308,0,-0.155086207253072,-0.00964630225080387
"United States","Nebraska","NE",2021-06-06,2021-06-12,7,2021,"23",1934408,305,26,313,-8,279,1.34408046285996,-0.413563219341525,-0.0255591054313099
"United States","Nebraska","NE",2021-06-13,2021-06-19,7,2021,"24",1934408,318,3,320,-2,315,0.155086207253072,-0.103390804835381,-0.00624999999999998
"United States","Nebraska","NE",2021-06-20,2021-06-26,7,2021,"25",1934408,300,0,319,-19,300,0,-0.982212645936121,-0.0595611285266457
"United States","Nebraska","NE",2021-06-27,2021-07-03,7,2021,"26",1934408,303,2,319,-16,301,0.103390804835381,-0.827126438683049,-0.0501567398119123
"United States","Nebraska","NE",2021-07-04,2021-07-10,7,2021,"27",1934408,208,0,318,-110,208,0,-5.68649426594596,-0.345911949685535
"United States","Nevada","NV",2019-12-29,2020-01-04,7,2020,"1",3080156,521,0,590,-69,521,0,-2.24014627830538,-0.116949152542373
"United States","Nevada","NV",2020-01-05,2020-01-11,7,2020,"2",3080156,556,0,591,-35,556,0,-1.13630608319838,-0.0592216582064298
"United States","Nevada","NV",2020-01-12,2020-01-18,7,2020,"3",3080156,605,0,586,19,605,0,0.616851873736265,0.0324232081911262
"United States","Nevada","NV",2020-01-19,2020-01-25,7,2020,"4",3080156,577,0,568,9,577,0,0.292192992822441,0.0158450704225352
"United States","Nevada","NV",2020-01-26,2020-02-01,7,2020,"5",3080156,532,0,559,-27,532,0,-0.876578978467324,-0.0483005366726297
"United States","Nevada","NV",2020-02-02,2020-02-08,7,2020,"6",3080156,579,0,549,30,579,0,0.973976642741472,0.0546448087431695
"United States","Nevada","NV",2020-02-09,2020-02-15,7,2020,"7",3080156,530,0,546,-16,530,0,-0.519454209462118,-0.0293040293040293
"United States","Nevada","NV",2020-02-16,2020-02-22,7,2020,"8",3080156,546,0,542,4,546,0,0.12986355236553,0.00738007380073791
"United States","Nevada","NV",2020-02-23,2020-02-29,7,2020,"9",3080156,544,0,549,-5,544,0,-0.162329440456912,-0.00910746812386154
"United States","Nevada","NV",2020-03-01,2020-03-07,7,2020,"10",3080156,535,0,547,-12,535,0,-0.389590657096589,-0.0219378427787934
"United States","Nevada","NV",2020-03-08,2020-03-14,7,2020,"11",3080156,515,0,544,-29,515,0,-0.941510754650089,-0.0533088235294118
"United States","Nevada","NV",2020-03-15,2020-03-21,7,2020,"12",3080156,508,2,539,-31,506,0.0649317761827648,-1.00644253083285,-0.0575139146567718
"United States","Nevada","NV",2020-03-22,2020-03-28,7,2020,"13",3080156,543,12,536,7,531,0.389590657096589,0.227261216639677,0.0130597014925373
"United States","Nevada","NV",2020-03-29,2020-04-04,7,2020,"14",3080156,593,32,526,67,561,1.03890841892424,2.17521450212262,0.127376425855513
"United States","Nevada","NV",2020-04-05,2020-04-11,7,2020,"15",3080156,588,56,526,62,532,1.81808973311741,2.01288506166571,0.11787072243346
"United States","Nevada","NV",2020-04-12,2020-04-18,7,2020,"16",3080156,546,66,522,24,480,2.14274861403124,0.779181314193177,0.0459770114942528
"United States","Nevada","NV",2020-04-19,2020-04-25,7,2020,"17",3080156,565,48,512,53,517,1.55836262838635,1.72069206884327,0.103515625
"United States","Nevada","NV",2020-04-26,2020-05-02,7,2020,"18",3080156,547,53,508,39,494,1.72069206884327,1.26616963556391,0.0767716535433072
"United States","Nevada","NV",2020-05-03,2020-05-09,7,2020,"19",3080156,544,49,500,44,495,1.59082851647774,1.42849907602082,0.0880000000000001
"United States","Nevada","NV",2020-05-10,2020-05-16,7,2020,"20",3080156,514,44,493,21,470,1.42849907602082,0.68178364991903,0.0425963488843812
"United States","Nevada","NV",2020-05-17,2020-05-23,7,2020,"21",3080156,536,44,492,44,492,1.42849907602082,1.42849907602082,0.089430894308943
"United States","Nevada","NV",2020-05-24,2020-05-30,7,2020,"22",3080156,543,22,493,50,521,0.714249538010412,1.62329440456912,0.101419878296146
"United States","Nevada","NV",2020-05-31,2020-06-06,7,2020,"23",3080156,562,25,495,67,537,0.81164720228456,2.17521450212262,0.135353535353535
"United States","Nevada","NV",2020-06-07,2020-06-13,7,2020,"24",3080156,543,9,498,45,534,0.292192992822441,1.46096496411221,0.0903614457831325
"United States","Nevada","NV",2020-06-14,2020-06-20,7,2020,"25",3080156,519,23,502,17,496,0.746715426101795,0.551920097553501,0.0338645418326693
"United States","Nevada","NV",2020-06-21,2020-06-27,7,2020,"26",3080156,557,15,496,61,542,0.486988321370736,1.98041917357433,0.122983870967742
"United States","Nevada","NV",2020-06-28,2020-07-04,7,2020,"27",3080156,528,30,498,30,498,0.973976642741472,0.973976642741472,0.0602409638554218
"United States","Nevada","NV",2020-07-05,2020-07-11,7,2020,"28",3080156,633,59,488,145,574,1.91548739739156,4.70755377325045,0.297131147540984
"United States","Nevada","NV",2020-07-12,2020-07-18,7,2020,"29",3080156,640,57,479,161,583,1.8505556212088,5.22700798271256,0.336116910229645
"United States","Nevada","NV",2020-07-19,2020-07-25,7,2020,"30",3080156,657,86,472,185,571,2.79206637585889,6.00618929690574,0.391949152542373
"United States","Nevada","NV",2020-07-26,2020-08-01,7,2020,"31",3080156,620,100,467,153,520,3.24658880913824,4.9672808779815,0.32762312633833
"United States","Nevada","NV",2020-08-02,2020-08-08,7,2020,"32",3080156,694,117,456,238,577,3.79850890669174,7.72688136574901,0.521929824561403
"United States","Nevada","NV",2020-08-09,2020-08-15,7,2020,"33",3080156,662,120,458,204,542,3.89590657096589,6.62304117064201,0.445414847161572
"United States","Nevada","NV",2020-08-16,2020-08-22,7,2020,"34",3080156,648,128,458,190,520,4.15563367569695,6.16851873736265,0.414847161572052
"United States","Nevada","NV",2020-08-23,2020-08-29,7,2020,"35",3080156,633,105,464,169,528,3.40891824959515,5.48673508744362,0.364224137931034
"United States","Nevada","NV",2020-08-30,2020-09-05,7,2020,"36",3080156,640,86,460,180,554,2.79206637585889,5.84385985644883,0.391304347826087
"United States","Nevada","NV",2020-09-06,2020-09-12,7,2020,"37",3080156,559,61,463,96,498,1.98041917357433,3.11672525677271,0.207343412526998
"United States","Nevada","NV",2020-09-13,2020-09-19,7,2020,"38",3080156,537,79,463,74,458,2.56480515921921,2.4024757187623,0.159827213822894
"United States","Nevada","NV",2020-09-20,2020-09-26,7,2020,"39",3080156,528,54,463,65,474,1.75315795693465,2.11028272593986,0.140388768898488
"United States","Nevada","NV",2020-09-27,2020-10-03,7,2020,"40",3080156,564,38,471,93,526,1.23370374747253,3.01932759249856,0.197452229299363
"United States","Nevada","NV",2020-10-04,2020-10-10,7,2020,"41",3080156,558,39,467,91,519,1.26616963556391,2.9543958163158,0.194860813704497
"United States","Nevada","NV",2020-10-11,2020-10-17,7,2020,"42",3080156,526,48,479,47,478,1.55836262838635,1.52589674029497,0.0981210855949897
"United States","Nevada","NV",2020-10-18,2020-10-24,7,2020,"43",3080156,541,36,477,64,505,1.16877197128977,2.07781683784847,0.134171907756813
"United States","Nevada","NV",2020-10-25,2020-10-31,7,2020,"44",3080156,604,34,469,135,570,1.103840195107,4.38289489233662,0.287846481876333
"United States","Nevada","NV",2020-11-01,2020-11-07,7,2020,"45",3080156,555,71,473,82,484,2.30507805448815,2.66220282349336,0.173361522198731
"United States","Nevada","NV",2020-11-08,2020-11-14,7,2020,"46",3080156,631,57,489,142,574,1.8505556212088,4.6101561089763,0.29038854805726
"United States","Nevada","NV",2020-11-15,2020-11-21,7,2020,"47",3080156,663,102,490,173,561,3.311520585321,5.61659863980915,0.353061224489796
"United States","Nevada","NV",2020-11-22,2020-11-28,7,2020,"48",3080156,744,105,493,251,639,3.40891824959515,8.14893791093698,0.509127789046653
"United States","Nevada","NV",2020-11-29,2020-12-05,7,2020,"49",3080156,773,170,503,270,603,5.51920097553501,8.76578978467324,0.536779324055666
"United States","Nevada","NV",2020-12-06,2020-12-12,7,2020,"50",3080156,908,214,511,397,694,6.94770005155583,12.8889575722788,0.776908023483366
"United States","Nevada","NV",2020-12-13,2020-12-19,7,2020,"51",3080156,845,222,519,326,623,7.20742715628689,10.5838795177907,0.628131021194605
"United States","Nevada","NV",2020-12-20,2020-12-26,7,2020,"52",3080156,867,185,532,335,682,6.00618929690574,10.8760725106131,0.629699248120301
"United States","Nevada","NV",2020-12-27,2021-01-02,7,2020,"53",3080156,856,199,556,300,657,6.46071173018509,9.73976642741471,0.539568345323741
"United States","Nevada","NV",2021-01-03,2021-01-09,7,2021,"1",3080156,885,278,562,323,607,9.0255168894043,10.4864818535165,0.574733096085409
"United States","Nevada","NV",2021-01-10,2021-01-16,7,2021,"2",3080156,845,300,570,275,545,9.73976642741471,8.92811922513016,0.482456140350877
"United States","Nevada","NV",2021-01-17,2021-01-23,7,2021,"3",3080156,825,243,568,257,582,7.88921080620592,8.34373323948527,0.452464788732394
"United States","Nevada","NV",2021-01-24,2021-01-30,7,2021,"4",3080156,790,244,554,236,546,7.9216766942973,7.66194958956624,0.425992779783394
"United States","Nevada","NV",2021-01-31,2021-02-06,7,2021,"5",3080156,727,198,542,185,529,6.42824584209371,6.00618929690574,0.341328413284133
"United States","Nevada","NV",2021-02-07,2021-02-13,7,2021,"6",3080156,709,227,546,163,482,7.3697565967438,5.29193975889533,0.298534798534799
"United States","Nevada","NV",2021-02-14,2021-02-20,7,2021,"7",3080156,644,172,532,112,472,5.58413275171777,3.63617946623483,0.210526315789474
"United States","Nevada","NV",2021-02-21,2021-02-27,7,2021,"8",3080156,674,90,526,148,584,2.92192992822441,4.80495143752459,0.281368821292776
"United States","Nevada","NV",2021-02-28,2021-03-06,7,2021,"9",3080156,564,77,537,27,487,2.49987338303644,0.876578978467324,0.0502793296089385
"United States","Nevada","NV",2021-03-07,2021-03-13,7,2021,"10",3080156,612,60,535,77,552,1.94795328548294,2.49987338303644,0.14392523364486
"United States","Nevada","NV",2021-03-14,2021-03-20,7,2021,"11",3080156,601,71,535,66,530,2.30507805448815,2.14274861403124,0.123364485981308
"United States","Nevada","NV",2021-03-21,2021-03-27,7,2021,"12",3080156,556,61,528,28,495,1.98041917357433,0.909044866558707,0.053030303030303
"United States","Nevada","NV",2021-03-28,2021-04-03,7,2021,"13",3080156,581,38,526,55,543,1.23370374747253,1.78562384502603,0.104562737642586
"United States","Nevada","NV",2021-04-04,2021-04-10,7,2021,"14",3080156,549,171,526,23,378,5.55166686362639,0.746715426101795,0.043726235741445
"United States","Nevada","NV",2021-04-11,2021-04-17,7,2021,"15",3080156,539,33,526,13,506,1.07137430701562,0.422056545187971,0.0247148288973384
"United States","Nevada","NV",2021-04-18,2021-04-24,7,2021,"16",3080156,580,57,523,57,523,1.8505556212088,1.8505556212088,0.108986615678776
"United States","Nevada","NV",2021-04-25,2021-05-01,7,2021,"17",3080156,556,42,515,41,514,1.36356729983806,1.33110141174668,0.0796116504854369
"United States","Nevada","NV",2021-05-02,2021-05-08,7,2021,"18",3080156,589,34,508,81,555,1.103840195107,2.62973693540197,0.159448818897638
"United States","Nevada","NV",2021-05-09,2021-05-15,7,2021,"19",3080156,553,32,503,50,521,1.03890841892424,1.62329440456912,0.099403578528827
"United States","Nevada","NV",2021-05-16,2021-05-22,7,2021,"20",3080156,509,22,497,12,487,0.714249538010412,0.389590657096589,0.0241448692152917
"United States","Nevada","NV",2021-05-23,2021-05-29,7,2021,"21",3080156,497,34,503,-6,463,1.103840195107,-0.194795328548294,-0.0119284294234593
"United States","Nevada","NV",2021-05-30,2021-06-05,7,2021,"22",3080156,561,14,507,54,547,0.454522433279353,1.75315795693465,0.106508875739645
"United States","Nevada","NV",2021-06-06,2021-06-12,7,2021,"23",3080156,536,22,513,23,514,0.714249538010412,0.746715426101795,0.0448343079922027
"United States","Nevada","NV",2021-06-13,2021-06-19,7,2021,"24",3080156,551,27,528,23,524,0.876578978467324,0.746715426101795,0.043560606060606
"United States","Nevada","NV",2021-06-20,2021-06-26,7,2021,"25",3080156,512,18,524,-12,494,0.584385985644883,-0.389590657096589,-0.0229007633587787
"United States","Nevada","NV",2021-06-27,2021-07-03,7,2021,"26",3080156,500,30,520,-20,470,0.973976642741472,-0.649317761827648,-0.0384615384615384
"United States","Nevada","NV",2021-07-04,2021-07-10,7,2021,"27",3080156,455,23,512,-57,432,0.746715426101795,-1.8505556212088,-0.111328125
"United States","New Hampshire","NH",2019-12-29,2020-01-04,7,2020,"1",1359711,260,0,267,-7,260,0,-0.514815280600069,-0.0262172284644194
"United States","New Hampshire","NH",2020-01-05,2020-01-11,7,2020,"2",1359711,263,0,269,-6,263,0,-0.441270240514345,-0.0223048327137546
"United States","New Hampshire","NH",2020-01-12,2020-01-18,7,2020,"3",1359711,245,0,271,-26,245,0,-1.91217104222883,-0.0959409594095941
"United States","New Hampshire","NH",2020-01-19,2020-01-25,7,2020,"4",1359711,241,0,272,-31,241,0,-2.27989624265745,-0.113970588235294
"United States","New Hampshire","NH",2020-01-26,2020-02-01,7,2020,"5",1359711,240,0,270,-30,240,0,-2.20635120257172,-0.111111111111111
"United States","New Hampshire","NH",2020-02-02,2020-02-08,7,2020,"6",1359711,256,0,273,-17,256,0,-1.25026568145731,-0.0622710622710623
"United States","New Hampshire","NH",2020-02-09,2020-02-15,7,2020,"7",1359711,236,0,271,-35,236,0,-2.57407640300034,-0.129151291512915
"United States","New Hampshire","NH",2020-02-16,2020-02-22,7,2020,"8",1359711,277,0,271,6,277,0,0.441270240514345,0.0221402214022139
"United States","New Hampshire","NH",2020-02-23,2020-02-29,7,2020,"9",1359711,228,0,264,-36,228,0,-2.64762144308607,-0.136363636363636
"United States","New Hampshire","NH",2020-03-01,2020-03-07,7,2020,"10",1359711,266,0,255,11,266,0,0.808995440942965,0.0431372549019609
"United States","New Hampshire","NH",2020-03-08,2020-03-14,7,2020,"11",1359711,240,0,247,-7,240,0,-0.514815280600069,-0.02834008097166
"United States","New Hampshire","NH",2020-03-15,2020-03-21,7,2020,"12",1359711,252,0,248,4,252,0,0.294180160342896,0.0161290322580645
"United States","New Hampshire","NH",2020-03-22,2020-03-28,7,2020,"13",1359711,258,3,246,12,255,0.220635120257172,0.882540481028689,0.0487804878048781
"United States","New Hampshire","NH",2020-03-29,2020-04-04,7,2020,"14",1359711,248,6,245,3,242,0.441270240514345,0.220635120257172,0.0122448979591836
"United States","New Hampshire","NH",2020-04-05,2020-04-11,7,2020,"15",1359711,270,14,251,19,256,1.02963056120014,1.39735576162876,0.0756972111553784
"United States","New Hampshire","NH",2020-04-12,2020-04-18,7,2020,"16",1359711,242,15,253,-11,227,1.10317560128586,-0.808995440942965,-0.0434782608695652
"United States","New Hampshire","NH",2020-04-19,2020-04-25,7,2020,"17",1359711,274,22,251,23,252,1.61799088188593,1.69153592197165,0.0916334661354581
"United States","New Hampshire","NH",2020-04-26,2020-05-02,7,2020,"18",1359711,266,24,252,14,242,1.76508096205738,1.02963056120014,0.0555555555555556
"United States","New Hampshire","NH",2020-05-03,2020-05-09,7,2020,"19",1359711,292,47,250,42,245,3.45661688402903,3.08889168360041,0.168
"United States","New Hampshire","NH",2020-05-10,2020-05-16,7,2020,"20",1359711,285,40,242,43,245,2.94180160342896,3.16243672368614,0.177685950413223
"United States","New Hampshire","NH",2020-05-17,2020-05-23,7,2020,"21",1359711,268,37,240,28,231,2.72116648317179,2.05926112240028,0.116666666666667
"United States","New Hampshire","NH",2020-05-24,2020-05-30,7,2020,"22",1359711,250,34,237,13,216,2.50053136291462,0.956085521114413,0.0548523206751055
"United States","New Hampshire","NH",2020-05-31,2020-06-06,7,2020,"23",1359711,259,41,233,26,218,3.01534664351469,1.91217104222883,0.111587982832618
"United States","New Hampshire","NH",2020-06-07,2020-06-13,7,2020,"24",1359711,302,35,230,72,267,2.57407640300034,5.29524288617214,0.31304347826087
"United States","New Hampshire","NH",2020-06-14,2020-06-20,7,2020,"25",1359711,238,21,232,6,217,1.54444584180021,0.441270240514345,0.0258620689655173
"United States","New Hampshire","NH",2020-06-21,2020-06-27,7,2020,"26",1359711,250,28,236,14,222,2.05926112240028,1.02963056120014,0.0593220338983051
"United States","New Hampshire","NH",2020-06-28,2020-07-04,7,2020,"27",1359711,247,9,235,12,238,0.661905360771517,0.882540481028689,0.0510638297872341
"United States","New Hampshire","NH",2020-07-05,2020-07-11,7,2020,"28",1359711,249,15,237,12,234,1.10317560128586,0.882540481028689,0.0506329113924051
"United States","New Hampshire","NH",2020-07-12,2020-07-18,7,2020,"29",1359711,231,5,238,-7,226,0.367725200428621,-0.514815280600069,-0.0294117647058824
"United States","New Hampshire","NH",2020-07-19,2020-07-25,7,2020,"30",1359711,266,13,239,27,253,0.956085521114413,1.98571608231455,0.112970711297071
"United States","New Hampshire","NH",2020-07-26,2020-08-01,7,2020,"31",1359711,248,7,239,9,241,0.514815280600069,0.661905360771517,0.0376569037656904
"United States","New Hampshire","NH",2020-08-02,2020-08-08,7,2020,"32",1359711,233,3,238,-5,230,0.220635120257172,-0.367725200428621,-0.0210084033613446
"United States","New Hampshire","NH",2020-08-09,2020-08-15,7,2020,"33",1359711,230,4,238,-8,226,0.294180160342896,-0.588360320685793,-0.0336134453781513
"United States","New Hampshire","NH",2020-08-16,2020-08-22,7,2020,"34",1359711,250,6,235,15,244,0.441270240514345,1.10317560128586,0.0638297872340425
"United States","New Hampshire","NH",2020-08-23,2020-08-29,7,2020,"35",1359711,231,3,239,-8,228,0.220635120257172,-0.588360320685793,-0.0334728033472803
"United States","New Hampshire","NH",2020-08-30,2020-09-05,7,2020,"36",1359711,234,0,241,-7,234,0,-0.514815280600069,-0.029045643153527
"United States","New Hampshire","NH",2020-09-06,2020-09-12,7,2020,"37",1359711,228,3,239,-11,225,0.220635120257172,-0.808995440942965,-0.0460251046025104
"United States","New Hampshire","NH",2020-09-13,2020-09-19,7,2020,"38",1359711,226,3,241,-15,223,0.220635120257172,-1.10317560128586,-0.0622406639004149
"United States","New Hampshire","NH",2020-09-20,2020-09-26,7,2020,"39",1359711,273,1,247,26,272,0.0735450400857241,1.91217104222883,0.105263157894737
"United States","New Hampshire","NH",2020-09-27,2020-10-03,7,2020,"40",1359711,222,3,245,-23,219,0.220635120257172,-1.69153592197165,-0.0938775510204082
"United States","New Hampshire","NH",2020-10-04,2020-10-10,7,2020,"41",1359711,255,13,244,11,242,0.956085521114413,0.808995440942965,0.0450819672131149
"United States","New Hampshire","NH",2020-10-11,2020-10-17,7,2020,"42",1359711,253,11,248,5,242,0.808995440942965,0.367725200428621,0.0201612903225807
"United States","New Hampshire","NH",2020-10-18,2020-10-24,7,2020,"43",1359711,234,7,250,-16,227,0.514815280600069,-1.17672064137159,-0.0639999999999999
"United States","New Hampshire","NH",2020-10-25,2020-10-31,7,2020,"44",1359711,257,10,245,12,247,0.735450400857241,0.882540481028689,0.0489795918367346
"United States","New Hampshire","NH",2020-11-01,2020-11-07,7,2020,"45",1359711,263,6,238,25,257,0.441270240514345,1.8386260021431,0.105042016806723
"United States","New Hampshire","NH",2020-11-08,2020-11-14,7,2020,"46",1359711,285,10,239,46,275,0.735450400857241,3.38307184394331,0.192468619246862
"United States","New Hampshire","NH",2020-11-15,2020-11-21,7,2020,"47",1359711,259,9,240,19,250,0.661905360771517,1.39735576162876,0.0791666666666666
"United States","New Hampshire","NH",2020-11-22,2020-11-28,7,2020,"48",1359711,284,6,242,42,278,0.441270240514345,3.08889168360041,0.173553719008265
"United States","New Hampshire","NH",2020-11-29,2020-12-05,7,2020,"49",1359711,313,45,244,69,268,3.30952680385758,5.07460776591496,0.282786885245902
"United States","New Hampshire","NH",2020-12-06,2020-12-12,7,2020,"50",1359711,312,41,251,61,271,3.01534664351469,4.48624744522917,0.243027888446215
"United States","New Hampshire","NH",2020-12-13,2020-12-19,7,2020,"51",1359711,288,50,251,37,238,3.6772520042862,2.72116648317179,0.147410358565737
"United States","New Hampshire","NH",2020-12-20,2020-12-26,7,2020,"52",1359711,357,6,252,105,351,0.441270240514345,7.72222920900103,0.416666666666667
"United States","New Hampshire","NH",2020-12-27,2021-01-02,7,2020,"53",1359711,305,113,256,49,192,8.31058952968682,3.60370696420048,0.19140625
"United States","New Hampshire","NH",2021-01-03,2021-01-09,7,2021,"1",1359711,323,77,254,69,246,5.66296808660076,5.07460776591496,0.271653543307087
"United States","New Hampshire","NH",2021-01-10,2021-01-16,7,2021,"2",1359711,357,81,257,100,276,5.95714824694365,7.35450400857241,0.389105058365759
"United States","New Hampshire","NH",2021-01-17,2021-01-23,7,2021,"3",1359711,296,44,261,35,252,3.23598176377186,2.57407640300034,0.134099616858238
"United States","New Hampshire","NH",2021-01-24,2021-01-30,7,2021,"4",1359711,276,71,262,14,205,5.22169784608641,1.02963056120014,0.0534351145038168
"United States","New Hampshire","NH",2021-01-31,2021-02-06,7,2021,"5",1359711,293,56,262,31,237,4.11852224480055,2.27989624265745,0.118320610687023
"United States","New Hampshire","NH",2021-02-07,2021-02-13,7,2021,"6",1359711,261,32,264,-3,229,2.35344128274317,-0.220635120257172,-0.0113636363636364
"United States","New Hampshire","NH",2021-02-14,2021-02-20,7,2021,"7",1359711,268,23,256,12,245,1.69153592197165,0.882540481028689,0.046875
"United States","New Hampshire","NH",2021-02-21,2021-02-27,7,2021,"8",1359711,248,17,256,-8,231,1.25026568145731,-0.588360320685793,-0.03125
"United States","New Hampshire","NH",2021-02-28,2021-03-06,7,2021,"9",1359711,250,11,252,-2,239,0.808995440942965,-0.147090080171448,-0.00793650793650791
"United States","New Hampshire","NH",2021-03-07,2021-03-13,7,2021,"10",1359711,240,14,243,-3,226,1.02963056120014,-0.220635120257172,-0.0123456790123457
"United States","New Hampshire","NH",2021-03-14,2021-03-20,7,2021,"11",1359711,234,22,238,-4,212,1.61799088188593,-0.294180160342896,-0.0168067226890757
"United States","New Hampshire","NH",2021-03-21,2021-03-27,7,2021,"12",1359711,249,14,240,9,235,1.02963056120014,0.661905360771517,0.0375000000000001
"United States","New Hampshire","NH",2021-03-28,2021-04-03,7,2021,"13",1359711,217,16,231,-14,201,1.17672064137159,-1.02963056120014,-0.0606060606060606
"United States","New Hampshire","NH",2021-04-04,2021-04-10,7,2021,"14",1359711,233,9,235,-2,224,0.661905360771517,-0.147090080171448,-0.00851063829787235
"United States","New Hampshire","NH",2021-04-11,2021-04-17,7,2021,"15",1359711,228,10,238,-10,218,0.735450400857241,-0.735450400857241,-0.042016806722689
"United States","New Hampshire","NH",2021-04-18,2021-04-24,7,2021,"16",1359711,257,16,235,22,241,1.17672064137159,1.61799088188593,0.0936170212765957
"United States","New Hampshire","NH",2021-04-25,2021-05-01,7,2021,"17",1359711,249,22,235,14,227,1.61799088188593,1.02963056120014,0.0595744680851065
"United States","New Hampshire","NH",2021-05-02,2021-05-08,7,2021,"18",1359711,248,10,235,13,238,0.735450400857241,0.956085521114413,0.0553191489361702
"United States","New Hampshire","NH",2021-05-09,2021-05-15,7,2021,"19",1359711,235,20,229,6,215,1.47090080171448,0.441270240514345,0.0262008733624455
"United States","New Hampshire","NH",2021-05-16,2021-05-22,7,2021,"20",1359711,274,13,222,52,261,0.956085521114413,3.82434208445765,0.234234234234234
"United States","New Hampshire","NH",2021-05-23,2021-05-29,7,2021,"21",1359711,232,8,217,15,224,0.588360320685793,1.10317560128586,0.0691244239631337
"United States","New Hampshire","NH",2021-05-30,2021-06-05,7,2021,"22",1359711,250,3,219,31,247,0.220635120257172,2.27989624265745,0.141552511415525
"United States","New Hampshire","NH",2021-06-06,2021-06-12,7,2021,"23",1359711,257,5,218,39,252,0.367725200428621,2.86825656334324,0.178899082568807
"United States","New Hampshire","NH",2021-06-13,2021-06-19,7,2021,"24",1359711,245,7,218,27,238,0.514815280600069,1.98571608231455,0.123853211009174
"United States","New Hampshire","NH",2021-06-20,2021-06-26,7,2021,"25",1359711,244,4,220,24,240,0.294180160342896,1.76508096205738,0.109090909090909
"United States","New Hampshire","NH",2021-06-27,2021-07-03,7,2021,"26",1359711,262,1,225,37,261,0.0735450400857241,2.72116648317179,0.164444444444444
"United States","New Hampshire","NH",2021-07-04,2021-07-10,7,2021,"27",1359711,236,3,225,11,233,0.220635120257172,0.808995440942965,0.048888888888889
"United States","New Jersey","NJ",2019-12-29,2020-01-04,7,2020,"1",8882190,1628,0,1620,8,1628,0,0.0900678774041087,0.0049382716049382
"United States","New Jersey","NJ",2020-01-05,2020-01-11,7,2020,"2",8882190,1588,0,1649,-61,1588,0,-0.686767565206329,-0.0369921164342025
"United States","New Jersey","NJ",2020-01-12,2020-01-18,7,2020,"3",8882190,1490,0,1656,-166,1490,0,-1.86890845613525,-0.10024154589372
"United States","New Jersey","NJ",2020-01-19,2020-01-25,7,2020,"4",8882190,1579,0,1656,-77,1579,0,-0.866903320014546,-0.0464975845410628
"United States","New Jersey","NJ",2020-01-26,2020-02-01,7,2020,"5",8882190,1517,0,1642,-125,1517,0,-1.4073105844392,-0.0761266747868453
"United States","New Jersey","NJ",2020-02-02,2020-02-08,7,2020,"6",8882190,1495,0,1625,-130,1495,0,-1.46360300781677,-0.08
"United States","New Jersey","NJ",2020-02-09,2020-02-15,7,2020,"7",8882190,1488,0,1602,-114,1488,0,-1.28346725300855,-0.0711610486891385
"United States","New Jersey","NJ",2020-02-16,2020-02-22,7,2020,"8",8882190,1494,0,1588,-94,1494,0,-1.05829755949828,-0.0591939546599496
"United States","New Jersey","NJ",2020-02-23,2020-02-29,7,2020,"9",8882190,1571,0,1559,12,1571,0,0.135101816106163,0.00769724182168052
"United States","New Jersey","NJ",2020-03-01,2020-03-07,7,2020,"10",8882190,1509,0,1553,-44,1509,0,-0.495373325722598,-0.0283322601416613
"United States","New Jersey","NJ",2020-03-08,2020-03-14,7,2020,"11",8882190,1477,1,1543,-66,1476,0.0112584846755136,-0.743059988583897,-0.0427738172391445
"United States","New Jersey","NJ",2020-03-15,2020-03-21,7,2020,"12",8882190,1600,15,1523,77,1585,0.168877270132704,0.866903320014546,0.0505581089954039
"United States","New Jersey","NJ",2020-03-22,2020-03-28,7,2020,"13",8882190,2124,124,1523,601,2000,1.39605209976368,6.76634928998366,0.394615889691398
"United States","New Jersey","NJ",2020-03-29,2020-04-04,7,2020,"14",8882190,3484,697,1506,1978,2787,7.84716381883297,22.2692826881659,1.31341301460823
"United States","New Jersey","NJ",2020-04-05,2020-04-11,7,2020,"15",8882190,4774,1346,1485,3289,3428,15.1539203732413,37.0291560977642,2.21481481481481
"United States","New Jersey","NJ",2020-04-12,2020-04-18,7,2020,"16",8882190,4733,1888,1474,3259,2845,21.2560190673696,36.6914015574988,2.21099050203528
"United States","New Jersey","NJ",2020-04-19,2020-04-25,7,2020,"17",8882190,3979,1795,1445,2534,2184,20.2089799925469,28.5290001677514,1.75363321799308
"United States","New Jersey","NJ",2020-04-26,2020-05-02,7,2020,"18",8882190,3181,1876,1425,1756,1305,21.1209172512635,19.7698990902019,1.23228070175439
"United States","New Jersey","NJ",2020-05-03,2020-05-09,7,2020,"19",8882190,2603,1373,1409,1194,1230,15.4578994594802,13.4426307025632,0.847409510290986
"United States","New Jersey","NJ",2020-05-10,2020-05-16,7,2020,"20",8882190,2287,1134,1391,896,1153,12.7671216220324,10.0876022692602,0.644140905823149
"United States","New Jersey","NJ",2020-05-17,2020-05-23,7,2020,"21",8882190,1937,831,1380,557,1106,9.35580076535179,6.27097596426107,0.403623188405797
"United States","New Jersey","NJ",2020-05-24,2020-05-30,7,2020,"22",8882190,1746,553,1385,361,1193,6.22594202555901,4.0643129678604,0.260649819494585
"United States","New Jersey","NJ",2020-05-31,2020-06-06,7,2020,"23",8882190,1587,472,1389,198,1115,5.31400476684241,2.22917996575169,0.142548596112311
"United States","New Jersey","NJ",2020-06-07,2020-06-13,7,2020,"24",8882190,1486,482,1378,108,1004,5.42658961359755,1.21591634495547,0.0783744557329462
"United States","New Jersey","NJ",2020-06-14,2020-06-20,7,2020,"25",8882190,1412,269,1385,27,1143,3.02853237771315,0.303979086238867,0.0194945848375452
"United States","New Jersey","NJ",2020-06-21,2020-06-27,7,2020,"26",8882190,1445,2092,1382,63,-647,23.5527499411744,0.709284534557356,0.0455861070911723
"United States","New Jersey","NJ",2020-06-28,2020-07-04,7,2020,"27",8882190,1407,241,1379,28,1166,2.71329480679877,0.31523757091438,0.0203045685279188
"United States","New Jersey","NJ",2020-07-05,2020-07-11,7,2020,"28",8882190,1389,336,1375,14,1053,3.78285085097256,0.15761878545719,0.0101818181818183
"United States","New Jersey","NJ",2020-07-12,2020-07-18,7,2020,"29",8882190,1324,174,1366,-42,1150,1.95897633353936,-0.472856356371571,-0.0307467057101025
"United States","New Jersey","NJ",2020-07-19,2020-07-25,7,2020,"30",8882190,1370,77,1353,17,1293,0.866903320014546,0.191394239483731,0.0125646711012564
"United States","New Jersey","NJ",2020-07-26,2020-08-01,7,2020,"31",8882190,1392,54,1357,35,1338,0.607958172477734,0.394046963642975,0.025792188651437
"United States","New Jersey","NJ",2020-08-02,2020-08-08,7,2020,"32",8882190,1344,39,1343,1,1305,0.43908090234503,0.0112584846755136,0.000744601638123621
"United States","New Jersey","NJ",2020-08-09,2020-08-15,7,2020,"33",8882190,1308,41,1346,-38,1267,0.461597871696057,-0.427822417669516,-0.0282317979197623
"United States","New Jersey","NJ",2020-08-16,2020-08-22,7,2020,"34",8882190,1341,33,1351,-10,1308,0.371529994291948,-0.112584846755136,-0.00740192450037014
"United States","New Jersey","NJ",2020-08-23,2020-08-29,7,2020,"35",8882190,1335,-10,1348,-13,1345,-0.112584846755136,-0.146360300781677,-0.00964391691394662
"United States","New Jersey","NJ",2020-08-30,2020-09-05,7,2020,"36",8882190,1397,52,1358,39,1345,0.585441203126706,0.43908090234503,0.0287187039764358
"United States","New Jersey","NJ",2020-09-06,2020-09-12,7,2020,"37",8882190,1389,42,1348,41,1347,0.472856356371571,0.461597871696057,0.0304154302670623
"United States","New Jersey","NJ",2020-09-13,2020-09-19,7,2020,"38",8882190,1378,37,1343,35,1341,0.416563932994003,0.394046963642975,0.0260610573343261
"United States","New Jersey","NJ",2020-09-20,2020-09-26,7,2020,"39",8882190,1395,39,1340,55,1356,0.43908090234503,0.619216657153247,0.041044776119403
"United States","New Jersey","NJ",2020-09-27,2020-10-03,7,2020,"40",8882190,1330,32,1342,-12,1298,0.360271509616435,-0.135101816106163,-0.00894187779433686
"United States","New Jersey","NJ",2020-10-04,2020-10-10,7,2020,"41",8882190,1401,36,1358,43,1365,0.405305448318489,0.484114841047084,0.0316642120765833
"United States","New Jersey","NJ",2020-10-11,2020-10-17,7,2020,"42",8882190,1341,33,1371,-30,1308,0.371529994291948,-0.337754540265408,-0.0218818380743983
"United States","New Jersey","NJ",2020-10-18,2020-10-24,7,2020,"43",8882190,1470,77,1369,101,1393,0.866903320014546,1.13710695222687,0.0737764791818847
"United States","New Jersey","NJ",2020-10-25,2020-10-31,7,2020,"44",8882190,1434,67,1378,56,1367,0.75431847325941,0.630475141828761,0.0406386066763424
"United States","New Jersey","NJ",2020-11-01,2020-11-07,7,2020,"45",8882190,1567,77,1400,167,1490,0.866903320014546,1.88016694081077,0.119285714285714
"United States","New Jersey","NJ",2020-11-08,2020-11-14,7,2020,"46",8882190,1632,123,1416,216,1509,1.38479361508817,2.43183268991093,0.152542372881356
"United States","New Jersey","NJ",2020-11-15,2020-11-21,7,2020,"47",8882190,1677,198,1425,252,1479,2.22917996575169,2.83713813822942,0.176842105263158
"United States","New Jersey","NJ",2020-11-22,2020-11-28,7,2020,"48",8882190,1697,219,1442,255,1478,2.46560814393747,2.87091359225596,0.176837725381415
"United States","New Jersey","NJ",2020-11-29,2020-12-05,7,2020,"49",8882190,1904,339,1455,449,1565,3.8166263049991,5.0550596193056,0.308591065292096
"United States","New Jersey","NJ",2020-12-06,2020-12-12,7,2020,"50",8882190,2026,427,1465,561,1599,4.8073729564443,6.31600990296312,0.382935153583618
"United States","New Jersey","NJ",2020-12-13,2020-12-19,7,2020,"51",8882190,2094,442,1481,613,1652,4.976250226577,6.90145110608983,0.413909520594193
"United States","New Jersey","NJ",2020-12-20,2020-12-26,7,2020,"52",8882190,2065,438,1498,567,1627,4.93121628787495,6.3835608110162,0.378504672897196
"United States","New Jersey","NJ",2020-12-27,2021-01-02,7,2020,"53",8882190,2215,576,1527,688,1639,6.48488717309582,7.74583745675335,0.450556647020301
"United States","New Jersey","NJ",2021-01-03,2021-01-09,7,2021,"1",8882190,2055,667,1550,505,1388,7.50940927856756,5.68553476113436,0.325806451612903
"United States","New Jersey","NJ",2021-01-10,2021-01-16,7,2021,"2",8882190,2159,560,1565,594,1599,6.30475141828761,6.68753989725507,0.379552715654952
"United States","New Jersey","NJ",2021-01-17,2021-01-23,7,2021,"3",8882190,1989,520,1581,408,1469,5.85441203126706,4.59346174760954,0.258064516129032
"United States","New Jersey","NJ",2021-01-24,2021-01-30,7,2021,"4",8882190,2020,521,1591,429,1499,5.86567051594258,4.82988992579533,0.269641734758014
"United States","New Jersey","NJ",2021-01-31,2021-02-06,7,2021,"5",8882190,2043,509,1592,451,1534,5.73056869983641,5.07757658865663,0.283291457286432
"United States","New Jersey","NJ",2021-02-07,2021-02-13,7,2021,"6",8882190,1874,476,1589,285,1398,5.35903870554447,3.20866813252137,0.179358086847074
"United States","New Jersey","NJ",2021-02-14,2021-02-20,7,2021,"7",8882190,1831,395,1568,263,1436,4.44710144682787,2.96098146966007,0.167729591836735
"United States","New Jersey","NJ",2021-02-21,2021-02-27,7,2021,"8",8882190,1807,404,1544,263,1403,4.54842780890749,2.96098146966007,0.170336787564767
"United States","New Jersey","NJ",2021-02-28,2021-03-06,7,2021,"9",8882190,1723,318,1523,200,1405,3.58019812681332,2.25169693510272,0.131319763624425
"United States","New Jersey","NJ",2021-03-07,2021-03-13,7,2021,"10",8882190,1594,331,1497,97,1263,3.726558427595,1.09207301352482,0.0647962591850368
"United States","New Jersey","NJ",2021-03-14,2021-03-20,7,2021,"11",8882190,1682,246,1480,202,1436,2.76958723017634,2.27421390445374,0.136486486486487
"United States","New Jersey","NJ",2021-03-21,2021-03-27,7,2021,"12",8882190,1631,248,1467,164,1383,2.79210419952737,1.84639148678423,0.111792774369462
"United States","New Jersey","NJ",2021-03-28,2021-04-03,7,2021,"13",8882190,1598,255,1456,142,1343,2.87091359225596,1.59870482392293,0.0975274725274726
"United States","New Jersey","NJ",2021-04-04,2021-04-10,7,2021,"14",8882190,1685,222,1442,243,1463,2.49938359796402,2.7358117761498,0.168515950069348
"United States","New Jersey","NJ",2021-04-11,2021-04-17,7,2021,"15",8882190,1590,275,1423,167,1315,3.09608328576624,1.88016694081077,0.117357695010541
"United States","New Jersey","NJ",2021-04-18,2021-04-24,7,2021,"16",8882190,1667,233,1404,263,1434,2.62322692939467,2.96098146966007,0.187321937321937
"United States","New Jersey","NJ",2021-04-25,2021-05-01,7,2021,"17",8882190,1649,221,1388,261,1428,2.4881251132885,2.93846450030905,0.188040345821326
"United States","New Jersey","NJ",2021-05-02,2021-05-08,7,2021,"18",8882190,1479,203,1377,102,1276,2.28547238912926,1.14836543690239,0.0740740740740742
"United States","New Jersey","NJ",2021-05-09,2021-05-15,7,2021,"19",8882190,1485,161,1380,105,1324,1.81261603275769,1.18214089092893,0.076086956521739
"United States","New Jersey","NJ",2021-05-16,2021-05-22,7,2021,"20",8882190,1474,132,1376,98,1342,1.48611997716779,1.10333149820033,0.0712209302325582
"United States","New Jersey","NJ",2021-05-23,2021-05-29,7,2021,"21",8882190,1342,75,1363,-21,1267,0.844386350663519,-0.236428178185785,-0.0154071900220103
"United States","New Jersey","NJ",2021-05-30,2021-06-05,7,2021,"22",8882190,1423,0,1360,63,1423,0,0.709284534557356,0.0463235294117648
"United States","New Jersey","NJ",2021-06-06,2021-06-12,7,2021,"23",8882190,1327,0,1365,-38,1327,0,-0.427822417669516,-0.0278388278388279
"United States","New Jersey","NJ",2021-06-13,2021-06-19,7,2021,"24",8882190,1368,198,1368,0,1170,2.22917996575169,0,0
"United States","New Jersey","NJ",2021-06-20,2021-06-26,7,2021,"25",8882190,1406,53,1371,35,1353,0.59669968780222,0.394046963642975,0.0255288110867979
"United States","New Jersey","NJ",2021-06-27,2021-07-03,7,2021,"26",8882190,1416,0,1369,47,1416,0,0.529148779749138,0.0343316289262234
"United States","New Jersey","NJ",2021-07-04,2021-07-10,7,2021,"27",8882190,1327,80,1381,-54,1247,0.900678774041087,-0.607958172477734,-0.0391020999275887
"United States","New Mexico","NM",2019-12-29,2020-01-04,7,2020,"1",2096829,408,0,390,18,408,0,0.858439100184135,0.0461538461538462
"United States","New Mexico","NM",2020-01-05,2020-01-11,7,2020,"2",2096829,410,0,393,17,410,0,0.810748039062794,0.0432569974554708
"United States","New Mexico","NM",2020-01-12,2020-01-18,7,2020,"3",2096829,388,0,394,-6,388,0,-0.286146366728045,-0.0152284263959391
"United States","New Mexico","NM",2020-01-19,2020-01-25,7,2020,"4",2096829,404,0,397,7,404,0,0.333837427849386,0.0176322418136021
"United States","New Mexico","NM",2020-01-26,2020-02-01,7,2020,"5",2096829,370,0,395,-25,370,0,-1.19227652803352,-0.0632911392405063
"United States","New Mexico","NM",2020-02-02,2020-02-08,7,2020,"6",2096829,377,0,396,-19,377,0,-0.906130161305476,-0.047979797979798
"United States","New Mexico","NM",2020-02-09,2020-02-15,7,2020,"7",2096829,382,0,397,-15,382,0,-0.715365916820113,-0.0377833753148614
"United States","New Mexico","NM",2020-02-16,2020-02-22,7,2020,"8",2096829,391,0,401,-10,391,0,-0.476910611213408,-0.0249376558603491
"United States","New Mexico","NM",2020-02-23,2020-02-29,7,2020,"9",2096829,396,0,393,3,396,0,0.143073183364023,0.00763358778625944
"United States","New Mexico","NM",2020-03-01,2020-03-07,7,2020,"10",2096829,400,0,398,2,400,0,0.0953821222426817,0.00502512562814061
"United States","New Mexico","NM",2020-03-08,2020-03-14,7,2020,"11",2096829,342,0,394,-52,342,0,-2.47993517830972,-0.131979695431472
"United States","New Mexico","NM",2020-03-15,2020-03-21,7,2020,"12",2096829,390,0,387,3,390,0,0.143073183364023,0.00775193798449614
"United States","New Mexico","NM",2020-03-22,2020-03-28,7,2020,"13",2096829,365,2,389,-24,363,0.0953821222426817,-1.14458546691218,-0.0616966580976864
"United States","New Mexico","NM",2020-03-29,2020-04-04,7,2020,"14",2096829,399,9,383,16,390,0.429219550092068,0.763056977941454,0.04177545691906
"United States","New Mexico","NM",2020-04-05,2020-04-11,7,2020,"15",2096829,411,9,380,31,402,0.429219550092068,1.47842289476157,0.081578947368421
"United States","New Mexico","NM",2020-04-12,2020-04-18,7,2020,"16",2096829,422,33,380,42,389,1.57380501700425,2.00302456709632,0.110526315789474
"United States","New Mexico","NM",2020-04-19,2020-04-25,7,2020,"17",2096829,407,40,381,26,367,1.90764244485363,1.23996758915486,0.068241469816273
"United States","New Mexico","NM",2020-04-26,2020-05-02,7,2020,"18",2096829,420,45,369,51,375,2.14609775046034,2.43224411718838,0.138211382113821
"United States","New Mexico","NM",2020-05-03,2020-05-09,7,2020,"19",2096829,442,53,367,75,389,2.52762623943106,3.57682958410056,0.204359673024523
"United States","New Mexico","NM",2020-05-10,2020-05-16,7,2020,"20",2096829,474,62,361,113,412,2.95684578952313,5.38908990671151,0.313019390581717
"United States","New Mexico","NM",2020-05-17,2020-05-23,7,2020,"21",2096829,396,55,366,30,341,2.62300836167375,1.43073183364023,0.0819672131147542
"United States","New Mexico","NM",2020-05-24,2020-05-30,7,2020,"22",2096829,433,43,360,73,390,2.05071562821766,3.48144746185788,0.202777777777778
"United States","New Mexico","NM",2020-05-31,2020-06-06,7,2020,"23",2096829,448,41,356,92,407,1.95533350597497,4.38757762316336,0.258426966292135
"United States","New Mexico","NM",2020-06-07,2020-06-13,7,2020,"24",2096829,445,39,354,91,406,1.85995138373229,4.33988656204202,0.257062146892655
"United States","New Mexico","NM",2020-06-14,2020-06-20,7,2020,"25",2096829,417,35,356,61,382,1.66918713924693,2.90915472840179,0.171348314606742
"United States","New Mexico","NM",2020-06-21,2020-06-27,7,2020,"26",2096829,399,25,348,51,374,1.19227652803352,2.43224411718838,0.146551724137931
"United States","New Mexico","NM",2020-06-28,2020-07-04,7,2020,"27",2096829,448,22,347,101,426,1.0492033446695,4.81679717325543,0.291066282420749
"United States","New Mexico","NM",2020-07-05,2020-07-11,7,2020,"28",2096829,408,30,346,62,378,1.43073183364023,2.95684578952313,0.179190751445087
"United States","New Mexico","NM",2020-07-12,2020-07-18,7,2020,"29",2096829,402,26,339,63,376,1.23996758915486,3.00453685064447,0.185840707964602
"United States","New Mexico","NM",2020-07-19,2020-07-25,7,2020,"30",2096829,435,38,341,94,397,1.81226032261095,4.48295974540604,0.275659824046921
"United States","New Mexico","NM",2020-07-26,2020-08-01,7,2020,"31",2096829,407,44,340,67,363,2.098406689339,3.19530109512984,0.197058823529412
"United States","New Mexico","NM",2020-08-02,2020-08-08,7,2020,"32",2096829,433,30,345,88,403,1.43073183364023,4.19681337867799,0.255072463768116
"United States","New Mexico","NM",2020-08-09,2020-08-15,7,2020,"33",2096829,394,30,342,52,364,1.43073183364023,2.47993517830972,0.152046783625731
"United States","New Mexico","NM",2020-08-16,2020-08-22,7,2020,"34",2096829,411,32,350,61,379,1.52611395588291,2.90915472840179,0.174285714285714
"United States","New Mexico","NM",2020-08-23,2020-08-29,7,2020,"35",2096829,397,26,347,50,371,1.23996758915486,2.38455305606704,0.144092219020173
"United States","New Mexico","NM",2020-08-30,2020-09-05,7,2020,"36",2096829,376,31,351,25,345,1.47842289476157,1.19227652803352,0.0712250712250713
"United States","New Mexico","NM",2020-09-06,2020-09-12,7,2020,"37",2096829,400,21,346,54,379,1.00151228354816,2.57531730055241,0.15606936416185
"United States","New Mexico","NM",2020-09-13,2020-09-19,7,2020,"38",2096829,398,26,348,50,372,1.23996758915486,2.38455305606704,0.14367816091954
"United States","New Mexico","NM",2020-09-20,2020-09-26,7,2020,"39",2096829,399,23,349,50,376,1.09689440579084,2.38455305606704,0.143266475644699
"United States","New Mexico","NM",2020-09-27,2020-10-03,7,2020,"40",2096829,388,20,345,43,368,0.953821222426817,2.05071562821766,0.12463768115942
"United States","New Mexico","NM",2020-10-04,2020-10-10,7,2020,"41",2096829,389,17,354,35,372,0.810748039062794,1.66918713924693,0.0988700564971752
"United States","New Mexico","NM",2020-10-11,2020-10-17,7,2020,"42",2096829,406,22,363,43,384,1.0492033446695,2.05071562821766,0.118457300275482
"United States","New Mexico","NM",2020-10-18,2020-10-24,7,2020,"43",2096829,434,36,364,70,398,1.71687820036827,3.33837427849386,0.192307692307692
"United States","New Mexico","NM",2020-10-25,2020-10-31,7,2020,"44",2096829,460,53,362,98,407,2.52762623943106,4.6737239898914,0.270718232044199
"United States","New Mexico","NM",2020-11-01,2020-11-07,7,2020,"45",2096829,519,86,361,158,433,4.10143125643531,7.53518765717185,0.437673130193906
"United States","New Mexico","NM",2020-11-08,2020-11-14,7,2020,"46",2096829,577,104,353,224,473,4.95987035661945,10.6827976911803,0.634560906515581
"United States","New Mexico","NM",2020-11-15,2020-11-21,7,2020,"47",2096829,587,142,357,230,445,6.7721306792304,10.9689440579084,0.644257703081232
"United States","New Mexico","NM",2020-11-22,2020-11-28,7,2020,"48",2096829,601,177,365,236,424,8.44131781847733,11.2550904246364,0.646575342465753
"United States","New Mexico","NM",2020-11-29,2020-12-05,7,2020,"49",2096829,662,211,359,303,451,10.0628138966029,14.4503915197663,0.844011142061281
"United States","New Mexico","NM",2020-12-06,2020-12-12,7,2020,"50",2096829,687,175,370,317,512,8.34593569623465,15.118066375465,0.856756756756757
"United States","New Mexico","NM",2020-12-13,2020-12-19,7,2020,"51",2096829,662,242,379,283,420,11.5412367913645,13.4965702973395,0.746701846965699
"United States","New Mexico","NM",2020-12-20,2020-12-26,7,2020,"52",2096829,626,161,379,247,465,7.67826084053588,11.7796920969712,0.651715039577836
"United States","New Mexico","NM",2020-12-27,2021-01-02,7,2020,"53",2096829,606,218,387,219,388,10.3966513244523,10.4443423855736,0.565891472868217
"United States","New Mexico","NM",2021-01-03,2021-01-09,7,2021,"1",2096829,585,198,410,175,387,9.44283010202549,8.34593569623465,0.426829268292683
"United States","New Mexico","NM",2021-01-10,2021-01-16,7,2021,"2",2096829,531,177,408,123,354,8.44131781847733,5.86600051792492,0.301470588235294
"United States","New Mexico","NM",2021-01-17,2021-01-23,7,2021,"3",2096829,530,206,404,126,324,9.82435859099621,6.00907370128895,0.311881188118812
"United States","New Mexico","NM",2021-01-24,2021-01-30,7,2021,"4",2096829,488,150,401,87,338,7.15365916820113,4.14912231755665,0.216957605985037
"United States","New Mexico","NM",2021-01-31,2021-02-06,7,2021,"5",2096829,474,121,401,73,353,5.77061839568224,3.48144746185788,0.182044887780549
"United States","New Mexico","NM",2021-02-07,2021-02-13,7,2021,"6",2096829,474,130,404,70,344,6.19983794577431,3.33837427849386,0.173267326732673
"United States","New Mexico","NM",2021-02-14,2021-02-20,7,2021,"7",2096829,443,94,399,44,349,4.48295974540604,2.098406689339,0.110275689223058
"United States","New Mexico","NM",2021-02-21,2021-02-27,7,2021,"8",2096829,470,90,405,65,380,4.29219550092068,3.09991897288716,0.160493827160494
"United States","New Mexico","NM",2021-02-28,2021-03-06,7,2021,"9",2096829,453,97,402,51,356,4.62603292877006,2.43224411718838,0.126865671641791
"United States","New Mexico","NM",2021-03-07,2021-03-13,7,2021,"10",2096829,410,54,401,9,356,2.57531730055241,0.429219550092068,0.0224438902743143
"United States","New Mexico","NM",2021-03-14,2021-03-20,7,2021,"11",2096829,452,38,392,60,414,1.81226032261095,2.86146366728045,0.153061224489796
"United States","New Mexico","NM",2021-03-21,2021-03-27,7,2021,"12",2096829,448,36,393,55,412,1.71687820036827,2.62300836167375,0.139949109414758
"United States","New Mexico","NM",2021-03-28,2021-04-03,7,2021,"13",2096829,440,24,390,50,416,1.14458546691218,2.38455305606704,0.128205128205128
"United States","New Mexico","NM",2021-04-04,2021-04-10,7,2021,"14",2096829,424,27,384,40,397,1.2876586502762,1.90764244485363,0.104166666666667
"United States","New Mexico","NM",2021-04-11,2021-04-17,7,2021,"15",2096829,437,25,384,53,412,1.19227652803352,2.52762623943106,0.138020833333333
"United States","New Mexico","NM",2021-04-18,2021-04-24,7,2021,"16",2096829,410,23,385,25,387,1.09689440579084,1.19227652803352,0.0649350649350648
"United States","New Mexico","NM",2021-04-25,2021-05-01,7,2021,"17",2096829,386,43,384,2,343,2.05071562821766,0.0953821222426817,0.00520833333333326
"United States","New Mexico","NM",2021-05-02,2021-05-08,7,2021,"18",2096829,412,31,378,34,381,1.47842289476157,1.62149607812559,0.08994708994709
"United States","New Mexico","NM",2021-05-09,2021-05-15,7,2021,"19",2096829,438,15,369,69,423,0.715365916820113,3.29068321737252,0.186991869918699
"United States","New Mexico","NM",2021-05-16,2021-05-22,7,2021,"20",2096829,412,18,368,44,394,0.858439100184135,2.098406689339,0.119565217391304
"United States","New Mexico","NM",2021-05-23,2021-05-29,7,2021,"21",2096829,401,132,369,32,269,6.29522006801699,1.52611395588291,0.0867208672086721
"United States","New Mexico","NM",2021-05-30,2021-06-05,7,2021,"22",2096829,412,17,368,44,395,0.810748039062794,2.098406689339,0.119565217391304
"United States","New Mexico","NM",2021-06-06,2021-06-12,7,2021,"23",2096829,350,17,365,-15,333,0.810748039062794,-0.715365916820113,-0.041095890410959
"United States","New Mexico","NM",2021-06-13,2021-06-19,7,2021,"24",2096829,381,19,368,13,362,0.906130161305476,0.619983794577431,0.0353260869565217
"United States","New Mexico","NM",2021-06-20,2021-06-26,7,2021,"25",2096829,353,19,374,-21,334,0.906130161305476,-1.00151228354816,-0.0561497326203209
"United States","New Mexico","NM",2021-06-27,2021-07-03,7,2021,"26",2096829,360,9,369,-9,351,0.429219550092068,-0.429219550092068,-0.024390243902439
"United States","New Mexico","NM",2021-07-04,2021-07-10,7,2021,"27",2096829,296,10,365,-69,286,0.476910611213408,-3.29068321737252,-0.189041095890411
"United States","New York","NY",2019-12-29,2020-01-04,7,2020,"1",19453561,3319,0,3379,-60,3319,0,-0.308426822215223,-0.017756732761172
"United States","New York","NY",2020-01-05,2020-01-11,7,2020,"2",19453561,3229,0,3404,-175,3229,0,-0.899578231461068,-0.0514101057579318
"United States","New York","NY",2020-01-12,2020-01-18,7,2020,"3",19453561,3298,0,3418,-120,3298,0,-0.616853644430446,-0.0351082504388531
"United States","New York","NY",2020-01-19,2020-01-25,7,2020,"4",19453561,3205,0,3395,-190,3205,0,-0.976684937014874,-0.0559646539027983
"United States","New York","NY",2020-01-26,2020-02-01,7,2020,"5",19453561,3202,0,3364,-162,3202,0,-0.832752419981103,-0.0481569560047562
"United States","New York","NY",2020-02-02,2020-02-08,7,2020,"6",19453561,3231,0,3329,-98,3231,0,-0.503763809618198,-0.0294382697506759
"United States","New York","NY",2020-02-09,2020-02-15,7,2020,"7",19453561,3120,0,3267,-147,3120,0,-0.755645714427297,-0.0449954086317723
"United States","New York","NY",2020-02-16,2020-02-22,7,2020,"8",19453561,3129,0,3244,-115,3129,0,-0.591151409245844,-0.0354500616522812
"United States","New York","NY",2020-02-23,2020-02-29,7,2020,"9",19453561,3271,0,3186,85,3271,0,0.436937998138233,0.0266792215944758
"United States","New York","NY",2020-03-01,2020-03-07,7,2020,"10",19453561,3185,0,3156,29,3185,0,0.149072964070691,0.00918884664131814
"United States","New York","NY",2020-03-08,2020-03-14,7,2020,"11",19453561,3117,3,3132,-15,3114,0.0154213411107612,-0.0771067055538058,-0.00478927203065138
"United States","New York","NY",2020-03-15,2020-03-21,7,2020,"12",19453561,3535,75,3096,439,3460,0.385533527769029,2.25665624920805,0.141795865633075
"United States","New York","NY",2020-03-22,2020-03-28,7,2020,"13",19453561,5350,914,3074,2276,4436,4.69836859174523,11.6996574560308,0.740403383214053
"United States","New York","NY",2020-03-29,2020-04-04,7,2020,"14",19453561,10070,3532,3060,7010,6538,18.1560589344028,36.0345337288119,2.29084967320261
"United States","New York","NY",2020-04-05,2020-04-11,7,2020,"15",19453561,12529,6588,3031,9498,5941,33.8652650792315,48.8239659566698,3.13361926756846
"United States","New York","NY",2020-04-12,2020-04-18,7,2020,"16",19453561,10365,5117,3006,7359,5248,26.3036674879216,37.8285497446971,2.44810379241517
"United States","New York","NY",2020-04-19,2020-04-25,7,2020,"17",19453561,7794,5242,2975,4819,2552,26.9462233675367,24.7718142709193,1.61983193277311
"United States","New York","NY",2020-04-26,2020-05-02,7,2020,"18",19453561,5976,2513,2938,3038,3463,12.9179434037809,15.6166780981641,1.03403675970048
"United States","New York","NY",2020-05-03,2020-05-09,7,2020,"19",19453561,4851,2737,2893,1958,2114,14.0694035400511,10.0649952982901,0.67680608365019
"United States","New York","NY",2020-05-10,2020-05-16,7,2020,"20",19453561,4111,1246,2891,1220,2865,6.4049970080028,6.27134538504287,0.421999308197855
"United States","New York","NY",2020-05-17,2020-05-23,7,2020,"21",19453561,3556,920,2854,702,2636,4.72921127396676,3.60859381991811,0.245970567624387
"United States","New York","NY",2020-05-24,2020-05-30,7,2020,"22",19453561,3281,671,2844,437,2610,3.44923996177358,2.24637535513421,0.15365682137834
"United States","New York","NY",2020-05-31,2020-06-06,7,2020,"23",19453561,3088,550,2880,208,2538,2.82724587030621,1.06921298367944,0.0722222222222222
"United States","New York","NY",2020-06-07,2020-06-13,7,2020,"24",19453561,2996,428,2846,150,2568,2.20011133180193,0.771067055538058,0.0527055516514405
"United States","New York","NY",2020-06-14,2020-06-20,7,2020,"25",19453561,2891,303,2850,41,2588,1.55755545218688,0.210758328513736,0.0143859649122806
"United States","New York","NY",2020-06-21,2020-06-27,7,2020,"26",19453561,3004,266,2871,133,2738,1.36735891182082,0.683679455910411,0.0463253221873912
"United States","New York","NY",2020-06-28,2020-07-04,7,2020,"27",19453561,2883,751,2852,31,2132,3.86047572472721,0.159353858144532,0.0108695652173914
"United States","New York","NY",2020-07-05,2020-07-11,7,2020,"28",19453561,2920,153,2815,105,2767,0.786488396648819,0.539746938876641,0.0373001776198933
"United States","New York","NY",2020-07-12,2020-07-18,7,2020,"29",19453561,2818,157,2797,21,2661,0.807050184796501,0.107949387775328,0.00750804433321406
"United States","New York","NY",2020-07-19,2020-07-25,7,2020,"30",19453561,2834,129,2778,56,2705,0.66311766776273,0.287865034067542,0.0201583873290136
"United States","New York","NY",2020-07-26,2020-08-01,7,2020,"31",19453561,2871,95,2764,107,2776,0.488342468507437,0.550027832950481,0.038712011577424
"United States","New York","NY",2020-08-02,2020-08-08,7,2020,"32",19453561,2841,60,2772,69,2781,0.308426822215223,0.354690845547507,0.024891774891775
"United States","New York","NY",2020-08-09,2020-08-15,7,2020,"33",19453561,2811,67,2766,45,2744,0.344409951473666,0.231320116661417,0.0162689804772234
"United States","New York","NY",2020-08-16,2020-08-22,7,2020,"34",19453561,2841,53,2773,68,2788,0.272443692956781,0.349550398510586,0.0245221781464118
"United States","New York","NY",2020-08-23,2020-08-29,7,2020,"35",19453561,2810,58,2771,39,2752,0.298145928141382,0.200477434439895,0.0140743413929989
"United States","New York","NY",2020-08-30,2020-09-05,7,2020,"36",19453561,2768,57,2776,-8,2711,0.293005481104462,-0.0411235762953631,-0.00288184438040351
"United States","New York","NY",2020-09-06,2020-09-12,7,2020,"37",19453561,2757,46,2774,-17,2711,0.236460563698338,-0.0873875996276466,-0.00612833453496753
"United States","New York","NY",2020-09-13,2020-09-19,7,2020,"38",19453561,2886,54,2793,93,2832,0.277584139993701,0.478061574433596,0.033297529538131
"United States","New York","NY",2020-09-20,2020-09-26,7,2020,"39",19453561,3080,34,2822,258,3046,0.174775199255293,1.32623533552546,0.0914245216158753
"United States","New York","NY",2020-09-27,2020-10-03,7,2020,"40",19453561,2951,80,2864,87,2871,0.411235762953631,0.447218892212074,0.030377094972067
"United States","New York","NY",2020-10-04,2020-10-10,7,2020,"41",19453561,3108,83,2905,203,3025,0.426657104064392,1.04351074849484,0.0698795180722891
"United States","New York","NY",2020-10-11,2020-10-17,7,2020,"42",19453561,2985,85,2926,59,2900,0.436937998138233,0.303286375178303,0.0201640464798361
"United States","New York","NY",2020-10-18,2020-10-24,7,2020,"43",19453561,2939,81,2954,-15,2858,0.416376209990551,-0.0771067055538058,-0.00507786052809744
"United States","New York","NY",2020-10-25,2020-10-31,7,2020,"44",19453561,3076,116,2970,106,2960,0.596291856282765,0.544887385913561,0.0356902356902358
"United States","New York","NY",2020-11-01,2020-11-07,7,2020,"45",19453561,3317,134,2993,324,3183,0.688819902947332,1.66550483996221,0.108252589375209
"United States","New York","NY",2020-11-08,2020-11-14,7,2020,"46",19453561,3158,192,2994,164,2966,0.986965831088714,0.843033314054944,0.0547762191048764
"United States","New York","NY",2020-11-15,2020-11-21,7,2020,"47",19453561,3288,230,3010,278,3058,1.18230281849169,1.42904427626387,0.0923588039867109
"United States","New York","NY",2020-11-22,2020-11-28,7,2020,"48",19453561,3375,338,3029,346,3037,1.73747109847909,1.77859467477445,0.114229118520964
"United States","New York","NY",2020-11-29,2020-12-05,7,2020,"49",19453561,3569,461,3060,509,3108,2.3697460840203,2.61648754179248,0.166339869281046
"United States","New York","NY",2020-12-06,2020-12-12,7,2020,"50",19453561,3872,591,3096,776,3281,3.03800419881995,3.98898690065022,0.250645994832041
"United States","New York","NY",2020-12-13,2020-12-19,7,2020,"51",19453561,4118,827,3152,966,3291,4.25114969953316,4.96567183766509,0.306472081218274
"United States","New York","NY",2020-12-20,2020-12-26,7,2020,"52",19453561,4358,657,3171,1187,3701,3.37727370325669,6.1017106328245,0.37432986439609
"United States","New York","NY",2020-12-27,2021-01-02,7,2020,"53",19453561,4339,1315,3238,1101,3024,6.75968785355031,5.65963218764935,0.340024706609018
"United States","New York","NY",2021-01-03,2021-01-09,7,2021,"1",19453561,4549,1190,3276,1273,3359,6.11713197393526,6.54378907799965,0.388583638583639
"United States","New York","NY",2021-01-10,2021-01-16,7,2021,"2",19453561,4667,1341,3297,1370,3326,6.89333947651024,7.04241244058093,0.415529269032454
"United States","New York","NY",2021-01-17,2021-01-23,7,2021,"3",19453561,4540,1322,3302,1238,3218,6.79567098280875,6.36387343170744,0.374924288310115
"United States","New York","NY",2021-01-24,2021-01-30,7,2021,"4",19453561,4468,1311,3306,1162,3157,6.73912606540263,5.97319945690149,0.351482153660012
"United States","New York","NY",2021-01-31,2021-02-06,7,2021,"5",19453561,4415,1217,3281,1134,3198,6.25592404393211,5.82926693986772,0.345626333434928
"United States","New York","NY",2021-02-07,2021-02-13,7,2021,"6",19453561,4152,1090,3234,918,3062,5.60308727024322,4.71893037989292,0.283858998144712
"United States","New York","NY",2021-02-14,2021-02-20,7,2021,"7",19453561,4035,942,3223,812,3093,4.842301108779,4.17404299397935,0.251939187092771
"United States","New York","NY",2021-02-21,2021-02-27,7,2021,"8",19453561,3928,832,3198,730,3096,4.27685193471776,3.75252633695188,0.228267667292058
"United States","New York","NY",2021-02-28,2021-03-06,7,2021,"9",19453561,3662,646,3170,492,3016,3.32072878585057,2.52909994216483,0.155205047318612
"United States","New York","NY",2021-03-07,2021-03-13,7,2021,"10",19453561,3617,679,3139,478,2938,3.49036353806894,2.45713368364795,0.152277795476266
"United States","New York","NY",2021-03-14,2021-03-20,7,2021,"11",19453561,3500,469,3098,402,3031,2.41086966031566,2.066459708842,0.129761136216914
"United States","New York","NY",2021-03-21,2021-03-27,7,2021,"12",19453561,3582,675,3041,541,2907,3.46980174992126,2.78098184697393,0.177902005919106
"United States","New York","NY",2021-03-28,2021-04-03,7,2021,"13",19453561,3400,468,3015,385,2932,2.40572921327874,1.97907210921435,0.127694859038143
"United States","New York","NY",2021-04-04,2021-04-10,7,2021,"14",19453561,3467,479,2994,473,2988,2.46227413068487,2.43143144846334,0.157982631930528
"United States","New York","NY",2021-04-11,2021-04-17,7,2021,"15",19453561,3220,535,2963,257,2685,2.75013916475241,1.32109488848854,0.0867364157948025
"United States","New York","NY",2021-04-18,2021-04-24,7,2021,"16",19453561,3323,346,2937,386,2977,1.77859467477445,1.98421255625127,0.131426625808648
"United States","New York","NY",2021-04-25,2021-05-01,7,2021,"17",19453561,3222,314,2905,317,2908,1.614100369593,1.62952171070376,0.109122203098107
"United States","New York","NY",2021-05-02,2021-05-08,7,2021,"18",19453561,3119,131,2890,229,2988,0.673398561836571,1.17716237145477,0.0792387543252595
"United States","New York","NY",2021-05-09,2021-05-15,7,2021,"19",19453561,3117,503,2866,251,2614,2.58564485957095,1.29025220626702,0.0875785066294488
"United States","New York","NY",2021-05-16,2021-05-22,7,2021,"20",19453561,3206,200,2829,377,3006,1.02808940738408,1.93794853291899,0.133262636974196
"United States","New York","NY",2021-05-23,2021-05-29,7,2021,"21",19453561,2960,178,2813,147,2782,0.914999572571829,0.755645714427297,0.052257376466406
"United States","New York","NY",2021-05-30,2021-06-05,7,2021,"22",19453561,3061,137,2817,244,2924,0.704241244058093,1.25426907700857,0.0866169684061058
"United States","New York","NY",2021-06-06,2021-06-12,7,2021,"23",19453561,2858,107,2829,29,2751,0.550027832950481,0.149072964070691,0.0102509720749382
"United States","New York","NY",2021-06-13,2021-06-19,7,2021,"24",19453561,2908,78,2845,63,2830,0.40095486887979,0.323848163325984,0.0221441124780317
"United States","New York","NY",2021-06-20,2021-06-26,7,2021,"25",19453561,2887,39,2846,41,2848,0.200477434439895,0.210758328513736,0.0144061841180605
"United States","New York","NY",2021-06-27,2021-07-03,7,2021,"26",19453561,2982,52,2853,129,2930,0.26730324591986,0.66311766776273,0.0452155625657202
"United States","New York","NY",2021-07-04,2021-07-10,7,2021,"27",19453561,2826,34,2846,-20,2792,0.174775199255293,-0.102808940738408,-0.00702740688685877
"United States","North Carolina","NC",2019-12-29,2020-01-04,7,2020,"1",10488084,2003,0,2067,-64,2003,0,-0.610216317870833,-0.03096274794388
"United States","North Carolina","NC",2020-01-05,2020-01-11,7,2020,"2",10488084,1984,0,2096,-112,1984,0,-1.06787855627396,-0.0534351145038168
"United States","North Carolina","NC",2020-01-12,2020-01-18,7,2020,"3",10488084,1902,0,2101,-199,1902,0,-1.89739136337962,-0.0947168015230843
"United States","North Carolina","NC",2020-01-19,2020-01-25,7,2020,"4",10488084,1994,0,2084,-90,1994,0,-0.858116697005859,-0.0431861804222649
"United States","North Carolina","NC",2020-01-26,2020-02-01,7,2020,"5",10488084,1983,0,2079,-96,1983,0,-0.91532447680625,-0.0461760461760462
"United States","North Carolina","NC",2020-02-02,2020-02-08,7,2020,"6",10488084,2053,0,2069,-16,2053,0,-0.152554079467708,-0.00773320444659253
"United States","North Carolina","NC",2020-02-09,2020-02-15,7,2020,"7",10488084,2060,0,2046,14,2060,0,0.133484819534245,0.00684261974584555
"United States","North Carolina","NC",2020-02-16,2020-02-22,7,2020,"8",10488084,1925,0,2038,-113,1925,0,-1.07741318624069,-0.0554465161923454
"United States","North Carolina","NC",2020-02-23,2020-02-29,7,2020,"9",10488084,1972,0,2011,-39,1972,0,-0.371850568702539,-0.0193933366484336
"United States","North Carolina","NC",2020-03-01,2020-03-07,7,2020,"10",10488084,2032,0,1984,48,2032,0,0.457662238403125,0.0241935483870968
"United States","North Carolina","NC",2020-03-08,2020-03-14,7,2020,"11",10488084,2025,0,1991,34,2025,0,0.32417741886888,0.0170768458061277
"United States","North Carolina","NC",2020-03-15,2020-03-21,7,2020,"12",10488084,2052,0,1987,65,2052,0,0.619750947837565,0.0327126321087066
"United States","North Carolina","NC",2020-03-22,2020-03-28,7,2020,"13",10488084,1877,4,1965,-88,1873,0.0381385198669271,-0.839047437072396,-0.0447837150127226
"United States","North Carolina","NC",2020-03-29,2020-04-04,7,2020,"14",10488084,2024,20,1923,101,2004,0.190692599334635,0.962997626639909,0.0525221008840353
"United States","North Carolina","NC",2020-04-05,2020-04-11,7,2020,"15",10488084,2016,55,1891,125,1961,0.524404648170247,1.19182874584147,0.0661025912215758
"United States","North Carolina","NC",2020-04-12,2020-04-18,7,2020,"16",10488084,2029,84,1870,159,1945,0.800908917205469,1.51600616471035,0.0850267379679144
"United States","North Carolina","NC",2020-04-19,2020-04-25,7,2020,"17",10488084,2104,125,1844,260,1979,1.19182874584147,2.47900379135026,0.140997830802603
"United States","North Carolina","NC",2020-04-26,2020-05-02,7,2020,"18",10488084,1948,131,1818,130,1817,1.24903652564186,1.23950189567513,0.0715071507150715
"United States","North Carolina","NC",2020-05-03,2020-05-09,7,2020,"19",10488084,2059,123,1804,255,1936,1.17275948590801,2.4313306415166,0.141352549889135
"United States","North Carolina","NC",2020-05-10,2020-05-16,7,2020,"20",10488084,2039,105,1807,232,1934,1.00113614650684,2.21203415228177,0.128389596015495
"United States","North Carolina","NC",2020-05-17,2020-05-23,7,2020,"21",10488084,2061,84,1798,263,1977,0.800908917205469,2.50760768125046,0.146273637374861
"United States","North Carolina","NC",2020-05-24,2020-05-30,7,2020,"22",10488084,1991,144,1794,197,1847,1.37298671520937,1.87832210344616,0.109810479375697
"United States","North Carolina","NC",2020-05-31,2020-06-06,7,2020,"23",10488084,1967,115,1799,168,1852,1.09648244617415,1.60181783441094,0.093385214007782
"United States","North Carolina","NC",2020-06-07,2020-06-13,7,2020,"24",10488084,1878,114,1782,96,1764,1.08694781620742,0.91532447680625,0.0538720538720538
"United States","North Carolina","NC",2020-06-14,2020-06-20,7,2020,"25",10488084,1938,108,1785,153,1830,1.02974003640703,1.45879838490996,0.0857142857142856
"United States","North Carolina","NC",2020-06-21,2020-06-27,7,2020,"26",10488084,1946,106,1779,167,1840,1.01067077647357,1.59228320444421,0.0938729623383923
"United States","North Carolina","NC",2020-06-28,2020-07-04,7,2020,"27",10488084,2001,77,1766,235,1924,0.734166507438346,2.24063804218197,0.133069082672707
"United States","North Carolina","NC",2020-07-05,2020-07-11,7,2020,"28",10488084,1979,98,1763,216,1881,0.934393736739713,2.05948007281406,0.122518434486671
"United States","North Carolina","NC",2020-07-12,2020-07-18,7,2020,"29",10488084,2027,136,1753,274,1891,1.29670967547552,2.6124886108845,0.156303479749002
"United States","North Carolina","NC",2020-07-19,2020-07-25,7,2020,"30",10488084,2147,149,1730,417,1998,1.42065986504303,3.97594069612715,0.241040462427746
"United States","North Carolina","NC",2020-07-26,2020-08-01,7,2020,"31",10488084,2085,186,1714,371,1899,1.77344117381211,3.53734771765749,0.216452742123687
"United States","North Carolina","NC",2020-08-02,2020-08-08,7,2020,"32",10488084,2061,196,1716,345,1865,1.86878747347943,3.28944733852246,0.201048951048951
"United States","North Carolina","NC",2020-08-09,2020-08-15,7,2020,"33",10488084,2160,183,1712,448,1977,1.74483728391191,4.27151422509583,0.261682242990654
"United States","North Carolina","NC",2020-08-16,2020-08-22,7,2020,"34",10488084,2123,178,1718,405,1945,1.69716413407825,3.86152513652637,0.235739231664726
"United States","North Carolina","NC",2020-08-23,2020-08-29,7,2020,"35",10488084,2070,162,1718,352,1908,1.54461005461055,3.35618974828958,0.20488940628638
"United States","North Carolina","NC",2020-08-30,2020-09-05,7,2020,"36",10488084,2167,206,1716,451,1961,1.96413377314674,4.30011811499603,0.262820512820513
"United States","North Carolina","NC",2020-09-06,2020-09-12,7,2020,"37",10488084,2124,158,1729,395,1966,1.50647153474362,3.76617883685905,0.228455754771544
"United States","North Carolina","NC",2020-09-13,2020-09-19,7,2020,"38",10488084,2261,188,1740,521,2073,1.79251043374557,4.96754221266725,0.299425287356322
"United States","North Carolina","NC",2020-09-20,2020-09-26,7,2020,"39",10488084,2072,205,1741,331,1867,1.95459914318001,3.15596251898822,0.190120620333142
"United States","North Carolina","NC",2020-09-27,2020-10-03,7,2020,"40",10488084,2038,189,1772,266,1849,1.8020450637123,2.53621157115065,0.150112866817156
"United States","North Carolina","NC",2020-10-04,2020-10-10,7,2020,"41",10488084,2117,136,1772,345,1981,1.29670967547552,3.28944733852246,0.19469525959368
"United States","North Carolina","NC",2020-10-11,2020-10-17,7,2020,"42",10488084,2130,164,1784,346,1966,1.56367931454401,3.29898196848919,0.193946188340807
"United States","North Carolina","NC",2020-10-18,2020-10-24,7,2020,"43",10488084,2130,63,1799,331,2067,0.600681687904101,3.15596251898822,0.183991106170095
"United States","North Carolina","NC",2020-10-25,2020-10-31,7,2020,"44",10488084,2159,175,1812,347,1984,1.66856024417806,3.30851659845592,0.191501103752759
"United States","North Carolina","NC",2020-11-01,2020-11-07,7,2020,"45",10488084,2382,381,1829,553,2001,3.6326940173248,5.27265037160267,0.302351011481684
"United States","North Carolina","NC",2020-11-08,2020-11-14,7,2020,"46",10488084,2230,171,1845,385,2059,1.63042172431113,3.67083253719173,0.208672086720867
"United States","North Carolina","NC",2020-11-15,2020-11-21,7,2020,"47",10488084,2176,286,1856,320,1890,2.72690417048529,3.05108158935417,0.172413793103448
"United States","North Carolina","NC",2020-11-22,2020-11-28,7,2020,"48",10488084,2320,133,1874,446,2187,1.26810578557533,4.25244496516237,0.237993596584845
"United States","North Carolina","NC",2020-11-29,2020-12-05,7,2020,"49",10488084,2378,377,1905,473,2001,3.59455549745788,4.50987997426413,0.248293963254593
"United States","North Carolina","NC",2020-12-06,2020-12-12,7,2020,"50",10488084,2459,278,1926,533,2181,2.65062713075143,5.08195777226803,0.276739356178608
"United States","North Carolina","NC",2020-12-13,2020-12-19,7,2020,"51",10488084,2588,389,1956,632,2199,3.70897105705866,6.02588613897448,0.323108384458078
"United States","North Carolina","NC",2020-12-20,2020-12-26,7,2020,"52",10488084,2670,42,1984,686,2628,0.400454458602734,6.54075615717799,0.345766129032258
"United States","North Carolina","NC",2020-12-27,2021-01-02,7,2020,"53",10488084,2834,667,2016,818,2167,6.35959818781009,7.79932731278659,0.405753968253968
"United States","North Carolina","NC",2021-01-03,2021-01-09,7,2021,"1",10488084,2917,534,2024,893,2383,5.09149240223476,8.51442456029147,0.441205533596838
"United States","North Carolina","NC",2021-01-10,2021-01-16,7,2021,"2",10488084,2965,590,2046,919,2375,5.62543168037174,8.7623249394265,0.449169110459433
"United States","North Carolina","NC",2021-01-17,2021-01-23,7,2021,"3",10488084,2833,570,2069,764,2263,5.43473908103711,7.28445729458307,0.369260512324795
"United States","North Carolina","NC",2021-01-24,2021-01-30,7,2021,"4",10488084,2817,702,2065,752,2115,6.6933102366457,7.17004173498229,0.364164648910412
"United States","North Carolina","NC",2021-01-31,2021-02-06,7,2021,"5",10488084,1286,639,2071,-785,647,6.0926285487416,-7.48468452388444,-0.379043940125543
"United States","North Dakota","ND",2019-12-29,2020-01-04,7,2020,"1",762062,149,0,146,3,149,0,0.393668756610355,0.0205479452054795
"United States","North Dakota","ND",2020-01-05,2020-01-11,7,2020,"2",762062,151,0,149,2,151,0,0.262445837740236,0.0134228187919463
"United States","North Dakota","ND",2020-01-12,2020-01-18,7,2020,"3",762062,171,0,150,21,171,0,2.75568129627248,0.14
"United States","North Dakota","ND",2020-01-19,2020-01-25,7,2020,"4",762062,147,0,148,-1,147,0,-0.131222918870118,-0.0067567567567568
"United States","North Dakota","ND",2020-01-26,2020-02-01,7,2020,"5",762062,130,0,146,-16,130,0,-2.09956670192189,-0.10958904109589
"United States","North Dakota","ND",2020-02-02,2020-02-08,7,2020,"6",762062,138,0,148,-10,138,0,-1.31222918870118,-0.0675675675675675
"United States","North Dakota","ND",2020-02-09,2020-02-15,7,2020,"7",762062,148,0,143,5,148,0,0.656114594350591,0.034965034965035
"United States","North Dakota","ND",2020-02-16,2020-02-22,7,2020,"8",762062,176,0,145,31,176,0,4.06791048497366,0.213793103448276
"United States","North Dakota","ND",2020-02-23,2020-02-29,7,2020,"9",762062,152,0,146,6,152,0,0.787337513220709,0.0410958904109588
"United States","North Dakota","ND",2020-03-01,2020-03-07,7,2020,"10",762062,171,0,147,24,171,0,3.14935005288284,0.163265306122449
"United States","North Dakota","ND",2020-03-08,2020-03-14,7,2020,"11",762062,148,0,145,3,148,0,0.393668756610355,0.0206896551724138
"United States","North Dakota","ND",2020-03-15,2020-03-21,7,2020,"12",762062,150,0,144,6,150,0,0.787337513220709,0.0416666666666667
"United States","North Dakota","ND",2020-03-22,2020-03-28,7,2020,"13",762062,119,1,141,-22,118,0.131222918870118,-2.8869042151426,-0.156028368794326
"United States","North Dakota","ND",2020-03-29,2020-04-04,7,2020,"14",762062,140,2,139,1,138,0.262445837740236,0.131222918870118,0.0071942446043165
"United States","North Dakota","ND",2020-04-05,2020-04-11,7,2020,"15",762062,158,4,141,17,154,0.524891675480473,2.23078962079201,0.120567375886525
"United States","North Dakota","ND",2020-04-12,2020-04-18,7,2020,"16",762062,157,2,137,20,155,0.262445837740236,2.62445837740236,0.145985401459854
"United States","North Dakota","ND",2020-04-19,2020-04-25,7,2020,"17",762062,158,7,135,23,151,0.918560432090827,3.01812713401272,0.17037037037037
"United States","North Dakota","ND",2020-04-26,2020-05-02,7,2020,"18",762062,148,8,134,14,140,1.04978335096095,1.83712086418165,0.104477611940299
"United States","North Dakota","ND",2020-05-03,2020-05-09,7,2020,"19",762062,141,10,132,9,131,1.31222918870118,1.18100626983106,0.0681818181818181
"United States","North Dakota","ND",2020-05-10,2020-05-16,7,2020,"20",762062,153,8,131,22,145,1.04978335096095,2.8869042151426,0.16793893129771
"United States","North Dakota","ND",2020-05-17,2020-05-23,7,2020,"21",762062,140,10,130,10,130,1.31222918870118,1.31222918870118,0.0769230769230769
"United States","North Dakota","ND",2020-05-24,2020-05-30,7,2020,"22",762062,143,7,134,9,136,0.918560432090827,1.18100626983106,0.0671641791044777
"United States","North Dakota","ND",2020-05-31,2020-06-06,7,2020,"23",762062,161,13,132,29,148,1.70589794531154,3.80546464723343,0.21969696969697
"United States","North Dakota","ND",2020-06-07,2020-06-13,7,2020,"24",762062,143,2,131,12,141,0.262445837740236,1.57467502644142,0.0916030534351144
"United States","North Dakota","ND",2020-06-14,2020-06-20,7,2020,"25",762062,142,2,132,10,140,0.262445837740236,1.31222918870118,0.0757575757575757
"United States","North Dakota","ND",2020-06-21,2020-06-27,7,2020,"26",762062,131,2,131,0,129,0.262445837740236,0,0
"United States","North Dakota","ND",2020-06-28,2020-07-04,7,2020,"27",762062,117,2,127,-10,115,0.262445837740236,-1.31222918870118,-0.0787401574803149
"United States","North Dakota","ND",2020-07-05,2020-07-11,7,2020,"28",762062,135,7,127,8,128,0.918560432090827,1.04978335096095,0.0629921259842521
"United States","North Dakota","ND",2020-07-12,2020-07-18,7,2020,"29",762062,134,3,127,7,131,0.393668756610355,0.918560432090827,0.0551181102362204
"United States","North Dakota","ND",2020-07-19,2020-07-25,7,2020,"30",762062,132,9,125,7,123,1.18100626983106,0.918560432090827,0.056
"United States","North Dakota","ND",2020-07-26,2020-08-01,7,2020,"31",762062,139,4,124,15,135,0.524891675480473,1.96834378305177,0.120967741935484
"United States","North Dakota","ND",2020-08-02,2020-08-08,7,2020,"32",762062,154,9,125,29,145,1.18100626983106,3.80546464723343,0.232
"United States","North Dakota","ND",2020-08-09,2020-08-15,7,2020,"33",762062,136,9,122,14,127,1.18100626983106,1.83712086418165,0.114754098360656
"United States","North Dakota","ND",2020-08-16,2020-08-22,7,2020,"34",762062,132,14,120,12,118,1.83712086418165,1.57467502644142,0.1
"United States","North Dakota","ND",2020-08-23,2020-08-29,7,2020,"35",762062,141,6,123,18,135,0.787337513220709,2.36201253966213,0.146341463414634
"United States","North Dakota","ND",2020-08-30,2020-09-05,7,2020,"36",762062,163,14,125,38,149,1.83712086418165,4.98647091706449,0.304
"United States","North Dakota","ND",2020-09-06,2020-09-12,7,2020,"37",762062,143,12,127,16,131,1.57467502644142,2.09956670192189,0.125984251968504
"United States","North Dakota","ND",2020-09-13,2020-09-19,7,2020,"38",762062,165,25,129,36,140,3.28057297175295,4.72402507932425,0.279069767441861
"United States","North Dakota","ND",2020-09-20,2020-09-26,7,2020,"39",762062,178,19,135,43,159,2.49323545853225,5.64258551141508,0.318518518518518
"United States","North Dakota","ND",2020-09-27,2020-10-03,7,2020,"40",762062,197,60,135,62,137,7.87337513220709,8.13582096994733,0.459259259259259
"United States","North Dakota","ND",2020-10-04,2020-10-10,7,2020,"41",762062,239,65,135,104,174,8.52948972655768,13.6471835624923,0.77037037037037
"United States","North Dakota","ND",2020-10-11,2020-10-17,7,2020,"42",762062,223,63,138,85,160,8.26704388881745,11.15394810396,0.615942028985507
"United States","North Dakota","ND",2020-10-18,2020-10-24,7,2020,"43",762062,195,49,142,53,146,6.42992302463579,6.95481470011626,0.373239436619718
"United States","North Dakota","ND",2020-10-25,2020-10-31,7,2020,"44",762062,246,76,141,105,170,9.97294183412898,13.7784064813624,0.74468085106383
"United States","North Dakota","ND",2020-11-01,2020-11-07,7,2020,"45",762062,269,104,144,125,165,13.6471835624923,16.4028648587648,0.868055555555556
"United States","North Dakota","ND",2020-11-08,2020-11-14,7,2020,"46",762062,255,98,142,113,157,12.8598460492716,14.8281898323234,0.795774647887324
"United States","North Dakota","ND",2020-11-15,2020-11-21,7,2020,"47",762062,273,108,140,133,165,14.1720752379728,17.4526482097257,0.95
"United States","North Dakota","ND",2020-11-22,2020-11-28,7,2020,"48",762062,248,81,140,108,167,10.6290564284796,14.1720752379728,0.771428571428571
"United States","North Dakota","ND",2020-11-29,2020-12-05,7,2020,"49",762062,283,92,142,141,191,12.0725085360509,18.5024315606867,0.992957746478873
"United States","North Dakota","ND",2020-12-06,2020-12-12,7,2020,"50",762062,231,57,141,90,174,7.47970637559674,11.8100626983106,0.638297872340426
"United States","North Dakota","ND",2020-12-13,2020-12-19,7,2020,"51",762062,200,140,141,59,60,18.3712086418165,7.74215221333697,0.418439716312057
"United States","North Dakota","ND",2020-12-20,2020-12-26,7,2020,"52",762062,200,60,143,57,140,7.87337513220709,7.47970637559674,0.398601398601399
"United States","North Dakota","ND",2020-12-27,2021-01-02,7,2020,"53",762062,163,46,147,16,117,6.03625426802544,2.09956670192189,0.108843537414966
"United States","North Dakota","ND",2021-01-03,2021-01-09,7,2021,"1",762062,156,42,149,7,114,5.51136259254496,0.918560432090827,0.0469798657718121
"United States","North Dakota","ND",2021-01-10,2021-01-16,7,2021,"2",762062,153,29,149,4,124,3.80546464723343,0.524891675480473,0.0268456375838926
"United States","North Dakota","ND",2021-01-17,2021-01-23,7,2021,"3",762062,140,30,149,-9,110,3.93668756610354,-1.18100626983106,-0.0604026845637584
"United States","North Dakota","ND",2021-01-24,2021-01-30,7,2021,"4",762062,149,11,149,0,138,1.4434521075713,0,0
"United States","North Dakota","ND",2021-01-31,2021-02-06,7,2021,"5",762062,159,6,146,13,153,0.787337513220709,1.70589794531154,0.0890410958904109
"United States","North Dakota","ND",2021-02-07,2021-02-13,7,2021,"6",762062,121,4,147,-26,117,0.524891675480473,-3.41179589062307,-0.17687074829932
"United States","North Dakota","ND",2021-02-14,2021-02-20,7,2021,"7",762062,133,6,145,-12,127,0.787337513220709,-1.57467502644142,-0.0827586206896552
"United States","North Dakota","ND",2021-02-21,2021-02-27,7,2021,"8",762062,164,8,143,21,156,1.04978335096095,2.75568129627248,0.146853146853147
"United States","North Dakota","ND",2021-02-28,2021-03-06,7,2021,"9",762062,158,4,143,15,154,0.524891675480473,1.96834378305177,0.104895104895105
"United States","North Dakota","ND",2021-03-07,2021-03-13,7,2021,"10",762062,137,9,144,-7,128,1.18100626983106,-0.918560432090827,-0.0486111111111112
"United States","North Dakota","ND",2021-03-14,2021-03-20,7,2021,"11",762062,143,3,147,-4,140,0.393668756610355,-0.524891675480473,-0.0272108843537415
"United States","North Dakota","ND",2021-03-21,2021-03-27,7,2021,"12",762062,146,6,152,-6,140,0.787337513220709,-0.787337513220709,-0.0394736842105263
"United States","North Dakota","ND",2021-03-28,2021-04-03,7,2021,"13",762062,140,0,150,-10,140,0,-1.31222918870118,-0.0666666666666667
"United States","North Dakota","ND",2021-04-04,2021-04-10,7,2021,"14",762062,136,3,154,-18,133,0.393668756610355,-2.36201253966213,-0.116883116883117
"United States","North Dakota","ND",2021-04-11,2021-04-17,7,2021,"15",762062,147,8,155,-8,139,1.04978335096095,-1.04978335096095,-0.0516129032258065
"United States","North Dakota","ND",2021-04-18,2021-04-24,7,2021,"16",762062,127,7,151,-24,120,0.918560432090827,-3.14935005288284,-0.158940397350993
"United States","North Dakota","ND",2021-04-25,2021-05-01,7,2021,"17",762062,147,8,149,-2,139,1.04978335096095,-0.262445837740236,-0.0134228187919463
"United States","North Dakota","ND",2021-05-02,2021-05-08,7,2021,"18",762062,145,5,147,-2,140,0.656114594350591,-0.262445837740236,-0.0136054421768708
"United States","North Dakota","ND",2021-05-09,2021-05-15,7,2021,"19",762062,137,5,150,-13,132,0.656114594350591,-1.70589794531154,-0.0866666666666667
"United States","North Dakota","ND",2021-05-16,2021-05-22,7,2021,"20",762062,156,3,146,10,153,0.393668756610355,1.31222918870118,0.0684931506849316
"United States","North Dakota","ND",2021-05-23,2021-05-29,7,2021,"21",762062,123,5,147,-24,118,0.656114594350591,-3.14935005288284,-0.163265306122449
"United States","North Dakota","ND",2021-05-30,2021-06-05,7,2021,"22",762062,148,4,143,5,144,0.524891675480473,0.656114594350591,0.034965034965035
"United States","North Dakota","ND",2021-06-06,2021-06-12,7,2021,"23",762062,139,4,144,-5,135,0.524891675480473,-0.656114594350591,-0.0347222222222222
"United States","North Dakota","ND",2021-06-13,2021-06-19,7,2021,"24",762062,127,3,142,-15,124,0.393668756610355,-1.96834378305177,-0.105633802816901
"United States","North Dakota","ND",2021-06-20,2021-06-26,7,2021,"25",762062,151,5,141,10,146,0.656114594350591,1.31222918870118,0.0709219858156029
"United States","North Dakota","ND",2021-06-27,2021-07-03,7,2021,"26",762062,158,0,138,20,158,0,2.62445837740236,0.144927536231884
"United States","North Dakota","ND",2021-07-04,2021-07-10,7,2021,"27",762062,152,4,138,14,148,0.524891675480473,1.83712086418165,0.101449275362319
"United States","Ohio","OH",2019-12-29,2020-01-04,7,2020,"1",11689100,2541,0,2775,-234,2541,0,-2.00186498532821,-0.0843243243243244
"United States","Ohio","OH",2020-01-05,2020-01-11,7,2020,"2",11689100,2616,0,2834,-218,2616,0,-1.86498532821175,-0.0769230769230769
"United States","Ohio","OH",2020-01-12,2020-01-18,7,2020,"3",11689100,2477,0,2813,-336,2477,0,-2.87447279944564,-0.119445431923214
"United States","Ohio","OH",2020-01-19,2020-01-25,7,2020,"4",11689100,2564,0,2757,-193,2564,0,-1.65111086396729,-0.0700036271309394
"United States","Ohio","OH",2020-01-26,2020-02-01,7,2020,"5",11689100,2494,0,2693,-199,2494,0,-1.70244073538596,-0.0738952840698106
"United States","Ohio","OH",2020-02-02,2020-02-08,7,2020,"6",11689100,2533,0,2672,-139,2533,0,-1.18914202119924,-0.0520209580838323
"United States","Ohio","OH",2020-02-09,2020-02-15,7,2020,"7",11689100,2495,0,2660,-165,2495,0,-1.41157146401348,-0.0620300751879699
"United States","Ohio","OH",2020-02-16,2020-02-22,7,2020,"8",11689100,2527,0,2620,-93,2527,0,-0.795613006989417,-0.0354961832061069
"United States","Ohio","OH",2020-02-23,2020-02-29,7,2020,"9",11689100,2461,0,2565,-104,2461,0,-0.889717771256983,-0.0405458089668616
"United States","Ohio","OH",2020-03-01,2020-03-07,7,2020,"10",11689100,2509,0,2569,-60,2509,0,-0.513298714186721,-0.0233553912028026
"United States","Ohio","OH",2020-03-08,2020-03-14,7,2020,"11",11689100,2556,0,2565,-9,2556,0,-0.0769948071280081,-0.00350877192982457
"United States","Ohio","OH",2020-03-15,2020-03-21,7,2020,"12",11689100,2521,3,2562,-41,2518,0.025664935709336,-0.350754121360926,-0.0160031225604996
"United States","Ohio","OH",2020-03-22,2020-03-28,7,2020,"13",11689100,2511,22,2550,-39,2489,0.188209528535131,-0.333644164221369,-0.0152941176470588
"United States","Ohio","OH",2020-03-29,2020-04-04,7,2020,"14",11689100,2571,77,2549,22,2494,0.658733349872959,0.188209528535131,0.00863083562181255
"United States","Ohio","OH",2020-04-05,2020-04-11,7,2020,"15",11689100,2632,145,2526,106,2487,1.24047189261791,0.90682772839654,0.0419635787806809
"United States","Ohio","OH",2020-04-12,2020-04-18,7,2020,"16",11689100,2657,204,2526,131,2453,1.74521562823485,1.12070219264101,0.0518606492478226
"United States","Ohio","OH",2020-04-19,2020-04-25,7,2020,"17",11689100,2836,258,2472,364,2578,2.2071844710029,3.11401219939944,0.147249190938511
"United States","Ohio","OH",2020-04-26,2020-05-02,7,2020,"18",11689100,2737,312,2421,316,2425,2.66915331377095,2.70337322805006,0.130524576621231
"United States","Ohio","OH",2020-05-03,2020-05-09,7,2020,"19",11689100,2616,310,2378,238,2306,2.65204335663139,2.03608489960733,0.100084104289319
"United States","Ohio","OH",2020-05-10,2020-05-16,7,2020,"20",11689100,2685,279,2348,337,2406,2.38683902096825,2.88302777801542,0.143526405451448
"United States","Ohio","OH",2020-05-17,2020-05-23,7,2020,"21",11689100,2664,341,2322,342,2323,2.91724769229453,2.92580267086431,0.147286821705426
"United States","Ohio","OH",2020-05-24,2020-05-30,7,2020,"22",11689100,2530,195,2321,209,2335,1.66822082110684,1.78799052108374,0.0900473933649288
"United States","Ohio","OH",2020-05-31,2020-06-06,7,2020,"23",11689100,2597,224,2313,284,2373,1.91631519963042,2.42961391381715,0.122784262862084
"United States","Ohio","OH",2020-06-07,2020-06-13,7,2020,"24",11689100,2421,184,2307,114,2237,1.57411605683928,0.97526755695477,0.0494148244473342
"United States","Ohio","OH",2020-06-14,2020-06-20,7,2020,"25",11689100,2404,143,2298,106,2261,1.22336193547835,0.90682772839654,0.0461270670147955
"United States","Ohio","OH",2020-06-21,2020-06-27,7,2020,"26",11689100,2429,107,2315,114,2322,0.915382706966319,0.97526755695477,0.0492440604751621
"United States","Ohio","OH",2020-06-28,2020-07-04,7,2020,"27",11689100,2529,103,2318,211,2426,0.881162792687204,1.8051004782233,0.0910267471958586
"United States","Ohio","OH",2020-07-05,2020-07-11,7,2020,"28",11689100,2515,129,2283,232,2386,1.10359223550145,1.98475502818865,0.101620674551029
"United States","Ohio","OH",2020-07-12,2020-07-18,7,2020,"29",11689100,2537,96,2264,273,2441,0.821277942698753,2.33550914954958,0.120583038869258
"United States","Ohio","OH",2020-07-19,2020-07-25,7,2020,"30",11689100,2504,165,2252,252,2339,1.41157146401348,2.15585459958423,0.11190053285968
"United States","Ohio","OH",2020-07-26,2020-08-01,7,2020,"31",11689100,2621,218,2238,383,2403,1.86498532821175,3.27655679222524,0.171134941912422
"United States","Ohio","OH",2020-08-02,2020-08-08,7,2020,"32",11689100,2584,153,2223,361,2431,1.30891172117614,3.0883472636901,0.162393162393162
"United States","Ohio","OH",2020-08-09,2020-08-15,7,2020,"33",11689100,2588,156,2226,362,2432,1.33457665688547,3.09690224225988,0.162623539982031
"United States","Ohio","OH",2020-08-16,2020-08-22,7,2020,"34",11689100,2592,151,2238,354,2441,1.29180176403658,3.02846241370165,0.158176943699732
"United States","Ohio","OH",2020-08-23,2020-08-29,7,2020,"35",11689100,2650,286,2241,409,2364,2.4467238709567,3.49898623503948,0.182507809013833
"United States","Ohio","OH",2020-08-30,2020-09-05,7,2020,"36",11689100,2426,-5,2249,177,2431,-0.0427748928488934,1.51423120685083,0.0787016451756337
"United States","Ohio","OH",2020-09-06,2020-09-12,7,2020,"37",11689100,2557,155,2247,310,2402,1.3260216783157,2.65204335663139,0.137961726746773
"United States","Ohio","OH",2020-09-13,2020-09-19,7,2020,"38",11689100,2485,201,2255,230,2284,1.71955069252552,1.9676450710491,0.1019955654102
"United States","Ohio","OH",2020-09-20,2020-09-26,7,2020,"39",11689100,2630,128,2258,372,2502,1.09503725693167,3.18245202795767,0.16474756421612
"United States","Ohio","OH",2020-09-27,2020-10-03,7,2020,"40",11689100,2602,185,2264,338,2417,1.58267103540906,2.89158275658519,0.149293286219081
"United States","Ohio","OH",2020-10-04,2020-10-10,7,2020,"41",11689100,2665,72,2255,410,2593,0.615958457024065,3.50754121360926,0.181818181818182
"United States","Ohio","OH",2020-10-11,2020-10-17,7,2020,"42",11689100,2650,70,2273,377,2580,0.598848499884508,3.22522692080656,0.165860096788385
"United States","Ohio","OH",2020-10-18,2020-10-24,7,2020,"43",11689100,2691,139,2292,399,2552,1.18914202119924,3.41343644934169,0.174083769633508
"United States","Ohio","OH",2020-10-25,2020-10-31,7,2020,"44",11689100,2763,95,2309,454,2668,0.812722964128975,3.88396027067952,0.196621914248593
"United States","Ohio","OH",2020-11-01,2020-11-07,7,2020,"45",11689100,3028,205,2327,701,2823,1.75377060680463,5.99703997741486,0.301246239793726
"United States","Ohio","OH",2020-11-08,2020-11-14,7,2020,"46",11689100,3070,208,2358,712,2862,1.77943554251397,6.09114474168242,0.3019508057676
"United States","Ohio","OH",2020-11-15,2020-11-21,7,2020,"47",11689100,3256,28,2376,880,3228,0.239539399953803,7.52838114140524,0.37037037037037
"United States","Ohio","OH",2020-11-22,2020-11-28,7,2020,"48",11689100,3568,657,2383,1185,2911,5.62062092034459,10.1376496051877,0.497272345782627
"United States","Ohio","OH",2020-11-29,2020-12-05,7,2020,"49",11689100,3910,544,2408,1502,3366,4.6539083419596,12.8495778118076,0.62375415282392
"United States","Ohio","OH",2020-12-06,2020-12-12,7,2020,"50",11689100,4230,530,2426,1804,3700,4.5341386419827,15.4331813398807,0.74361088211047
"United States","Ohio","OH",2020-12-13,2020-12-19,7,2020,"51",11689100,4066,550,2437,1629,3516,4.70523821337828,13.9360600901695,0.668444809191629
"United States","Ohio","OH",2020-12-20,2020-12-26,7,2020,"52",11689100,3913,453,2480,1433,3460,3.87540529210974,12.2592842904929,0.577822580645161
"United States","Ohio","OH",2020-12-27,2021-01-02,7,2020,"53",11689100,3910,541,2522,1388,3369,4.62824340625027,11.8743102548528,0.55035685963521
"United States","Ohio","OH",2021-01-03,2021-01-09,7,2021,"1",11689100,3677,582,2568,1109,3095,4.97899752761119,9.48747123388456,0.431853582554517
"United States","Ohio","OH",2021-01-10,2021-01-16,7,2021,"2",11689100,3580,535,2607,973,3045,4.5769135348316,8.32399414839466,0.373225930187955
"United States","Ohio","OH",2021-01-17,2021-01-23,7,2021,"3",11689100,3284,546,2585,699,2738,4.67101829909916,5.9799300202753,0.270406189555126
"United States","Ohio","OH",2021-01-24,2021-01-30,7,2021,"4",11689100,3138,441,2577,561,2697,3.7727455492724,4.79934297764584,0.217694994179278
"United States","Ohio","OH",2021-01-31,2021-02-06,7,2021,"5",11689100,3119,532,2533,586,2587,4.55124859912226,5.01321744189031,0.231346229767075
"United States","Ohio","OH",2021-02-07,2021-02-13,7,2021,"6",11689100,2958,4687,2512,446,-1729,40.0971845565527,3.81552044212129,0.177547770700637
"United States","Ohio","OH",2021-02-14,2021-02-20,7,2021,"7",11689100,2858,422,2490,368,2436,3.6102009564466,3.14823211367856,0.147791164658635
"United States","Ohio","OH",2021-02-21,2021-02-27,7,2021,"8",11689100,2784,484,2502,282,2300,4.14060962777288,2.41250395667759,0.112709832134293
"United States","Ohio","OH",2021-02-28,2021-03-06,7,2021,"9",11689100,2579,637,2490,89,1942,5.44952134894902,0.761393092710303,0.0357429718875502
"United States","Ohio","OH",2021-03-07,2021-03-13,7,2021,"10",11689100,2553,565,2506,47,1988,4.83356289192496,0.402083992779598,0.018754988028731
"United States","Ohio","OH",2021-03-14,2021-03-20,7,2021,"11",11689100,2411,338,2486,-75,2073,2.89158275658519,-0.641623392733401,-0.0301689460981497
"United States","Ohio","OH",2021-03-21,2021-03-27,7,2021,"12",11689100,2496,127,2458,38,2369,1.08648227836189,0.32508918565159,0.015459723352319
"United States","Ohio","OH",2021-03-28,2021-04-03,7,2021,"13",11689100,2400,-270,2452,-52,2670,-2.30984421384024,-0.444858885628492,-0.0212071778140294
"United States","Ohio","OH",2021-04-04,2021-04-10,7,2021,"14",11689100,2552,184,2440,112,2368,1.57411605683928,0.958157599815212,0.0459016393442624
"United States","Ohio","OH",2021-04-11,2021-04-17,7,2021,"15",11689100,2421,164,2415,6,2257,1.4030164854437,0.0513298714186721,0.00248447204968949
"United States","Ohio","OH",2021-04-18,2021-04-24,7,2021,"16",11689100,2580,131,2395,185,2449,1.12070219264101,1.58267103540906,0.0772442588726514
"United States","Ohio","OH",2021-04-25,2021-05-01,7,2021,"17",11689100,2481,162,2355,126,2319,1.38590652830415,1.07792729979211,0.0535031847133758
"United States","Ohio","OH",2021-05-02,2021-05-08,7,2021,"18",11689100,2412,144,2335,77,2268,1.23191691404813,0.658733349872959,0.0329764453961456
"United States","Ohio","OH",2021-05-09,2021-05-15,7,2021,"19",11689100,2422,100,2307,115,2322,0.855497856977868,0.983822535524548,0.0498482878196793
"United States","Ohio","OH",2021-05-16,2021-05-22,7,2021,"20",11689100,2558,181,2303,255,2377,1.54845112112994,2.18151953529356,0.110725141120278
"United States","Ohio","OH",2021-05-23,2021-05-29,7,2021,"21",11689100,2449,152,2277,172,2297,1.30035674260636,1.47145631400193,0.0755379885814669
"United States","Ohio","OH",2021-05-30,2021-06-05,7,2021,"22",11689100,2438,119,2266,172,2319,1.01804244980366,1.47145631400193,0.0759046778464254
"United States","Ohio","OH",2021-06-06,2021-06-12,7,2021,"23",11689100,2320,111,2278,42,2209,0.949602621245434,0.359309099930705,0.0184372256365233
"United States","Ohio","OH",2021-06-13,2021-06-19,7,2021,"24",11689100,2370,75,2276,94,2295,0.641623392733401,0.804167985559196,0.0413005272407734
"United States","Ohio","OH",2021-06-20,2021-06-26,7,2021,"25",11689100,2328,115,2284,44,2213,0.983822535524548,0.376419057070262,0.0192644483362523
"United States","Ohio","OH",2021-06-27,2021-07-03,7,2021,"26",11689100,2286,63,2283,3,2223,0.538963649896057,0.025664935709336,0.00131406044678051
"United States","Ohio","OH",2021-07-04,2021-07-10,7,2021,"27",11689100,2200,36,2269,-69,2164,0.307979228512033,-0.590293521314729,-0.0304098721903923
"United States","Oklahoma","OK",2019-12-29,2020-01-04,7,2020,"1",3956971,901,0,928,-27,901,0,-0.68234010307379,-0.0290948275862069
"United States","Oklahoma","OK",2020-01-05,2020-01-11,7,2020,"2",3956971,823,0,931,-108,823,0,-2.72936041229516,-0.116004296455424
"United States","Oklahoma","OK",2020-01-12,2020-01-18,7,2020,"3",3956971,850,0,941,-91,850,0,-2.29973886591537,-0.0967056323060573
"United States","Oklahoma","OK",2020-01-19,2020-01-25,7,2020,"4",3956971,803,0,925,-122,803,0,-3.08316639166676,-0.131891891891892
"United States","Oklahoma","OK",2020-01-26,2020-02-01,7,2020,"5",3956971,833,0,911,-78,833,0,-1.97120474221317,-0.0856201975850713
"United States","Oklahoma","OK",2020-02-02,2020-02-08,7,2020,"6",3956971,816,0,897,-81,816,0,-2.04702030922137,-0.0903010033444817
"United States","Oklahoma","OK",2020-02-09,2020-02-15,7,2020,"7",3956971,806,0,885,-79,806,0,-1.99647659788257,-0.0892655367231638
"United States","Oklahoma","OK",2020-02-16,2020-02-22,7,2020,"8",3956971,818,0,870,-52,818,0,-1.31413649480878,-0.0597701149425287
"United States","Oklahoma","OK",2020-02-23,2020-02-29,7,2020,"9",3956971,829,0,851,-22,829,0,-0.555980824726792,-0.0258519388954171
"United States","Oklahoma","OK",2020-03-01,2020-03-07,7,2020,"10",3956971,799,0,846,-47,799,0,-1.18777721646178,-0.0555555555555556
"United States","Oklahoma","OK",2020-03-08,2020-03-14,7,2020,"11",3956971,792,0,842,-50,792,0,-1.26359278346998,-0.0593824228028503
"United States","Oklahoma","OK",2020-03-15,2020-03-21,7,2020,"12",3956971,827,1,819,8,826,0.0252718556693996,0.202174845355197,0.00976800976800973
"United States","Oklahoma","OK",2020-03-22,2020-03-28,7,2020,"13",3956971,856,14,799,57,842,0.353805979371595,1.44049577315578,0.0713391739674594
"United States","Oklahoma","OK",2020-03-29,2020-04-04,7,2020,"14",3956971,784,27,783,1,757,0.68234010307379,0.0252718556693996,0.00127713920817363
"United States","Oklahoma","OK",2020-04-05,2020-04-11,7,2020,"15",3956971,857,52,772,85,805,1.31413649480878,2.14810773189897,0.110103626943005
"United States","Oklahoma","OK",2020-04-12,2020-04-18,7,2020,"16",3956971,799,37,779,20,762,0.935058659767787,0.505437113387993,0.0256739409499358
"United States","Oklahoma","OK",2020-04-19,2020-04-25,7,2020,"17",3956971,780,63,778,2,717,1.59212690717218,0.0505437113387993,0.00257069408740351
"United States","Oklahoma","OK",2020-04-26,2020-05-02,7,2020,"18",3956971,759,44,773,-14,715,1.11196164945358,-0.353805979371595,-0.018111254851229
"United States","Oklahoma","OK",2020-05-03,2020-05-09,7,2020,"19",3956971,776,32,764,12,744,0.808699381420789,0.303262268032796,0.0157068062827226
"United States","Oklahoma","OK",2020-05-10,2020-05-16,7,2020,"20",3956971,733,18,762,-29,715,0.454893402049194,-0.73288381441259,-0.0380577427821522
"United States","Oklahoma","OK",2020-05-17,2020-05-23,7,2020,"21",3956971,815,23,754,61,792,0.581252680396192,1.54158319583338,0.0809018567639257
"United States","Oklahoma","OK",2020-05-24,2020-05-30,7,2020,"22",3956971,740,22,743,-3,718,0.555980824726792,-0.075815567008199,-0.00403768506056523
"United States","Oklahoma","OK",2020-05-31,2020-06-06,7,2020,"23",3956971,789,14,742,47,775,0.353805979371595,1.18777721646178,0.0633423180592991
"United States","Oklahoma","OK",2020-06-07,2020-06-13,7,2020,"24",3956971,770,12,728,42,758,0.303262268032796,1.06141793811479,0.0576923076923077
"United States","Oklahoma","OK",2020-06-14,2020-06-20,7,2020,"25",3956971,741,9,727,14,732,0.227446701024597,0.353805979371595,0.0192572214580469
"United States","Oklahoma","OK",2020-06-21,2020-06-27,7,2020,"26",3956971,765,16,731,34,749,0.404349690710394,0.859243092759588,0.0465116279069768
"United States","Oklahoma","OK",2020-06-28,2020-07-04,7,2020,"27",3956971,781,14,734,47,767,0.353805979371595,1.18777721646178,0.0640326975476839
"United States","Oklahoma","OK",2020-07-05,2020-07-11,7,2020,"28",3956971,768,23,736,32,745,0.581252680396192,0.808699381420789,0.0434782608695652
"United States","Oklahoma","OK",2020-07-12,2020-07-18,7,2020,"29",3956971,794,30,727,67,764,0.758155670081989,1.69321432984978,0.0921595598349381
"United States","Oklahoma","OK",2020-07-19,2020-07-25,7,2020,"30",3956971,904,45,731,173,859,1.13723350512298,4.37203103080614,0.236662106703146
"United States","Oklahoma","OK",2020-07-26,2020-08-01,7,2020,"31",3956971,881,53,729,152,828,1.33940835047818,3.84132206174875,0.208504801097394
"United States","Oklahoma","OK",2020-08-02,2020-08-08,7,2020,"32",3956971,814,54,723,91,760,1.36468020614758,2.29973886591537,0.125864453665284
"United States","Oklahoma","OK",2020-08-09,2020-08-15,7,2020,"33",3956971,860,54,719,141,806,1.36468020614758,3.56333164938535,0.196105702364395
"United States","Oklahoma","OK",2020-08-16,2020-08-22,7,2020,"34",3956971,877,68,717,160,809,1.71848618551918,4.04349690710394,0.223152022315202
"United States","Oklahoma","OK",2020-08-23,2020-08-29,7,2020,"35",3956971,814,72,710,104,742,1.81957360819677,2.62827298961756,0.146478873239437
"United States","Oklahoma","OK",2020-08-30,2020-09-05,7,2020,"36",3956971,828,53,714,114,775,1.33940835047818,2.88099154631156,0.159663865546219
"United States","Oklahoma","OK",2020-09-06,2020-09-12,7,2020,"37",3956971,802,49,716,86,753,1.23832092780058,2.17337958756837,0.120111731843575
"United States","Oklahoma","OK",2020-09-13,2020-09-19,7,2020,"38",3956971,793,44,715,78,749,1.11196164945358,1.97120474221317,0.109090909090909
"United States","Oklahoma","OK",2020-09-20,2020-09-26,7,2020,"39",3956971,909,61,716,193,848,1.54158319583338,4.87746814419413,0.269553072625698
"United States","Oklahoma","OK",2020-09-27,2020-10-03,7,2020,"40",3956971,851,47,726,125,804,1.18777721646178,3.15898195867496,0.172176308539945
"United States","Oklahoma","OK",2020-10-04,2020-10-10,7,2020,"41",3956971,970,44,724,246,926,1.11196164945358,6.21687649467231,0.339779005524862
"United States","Oklahoma","OK",2020-10-11,2020-10-17,7,2020,"42",3956971,862,73,733,129,789,1.84484546386617,3.26006938135255,0.175989085948158
"United States","Oklahoma","OK",2020-10-18,2020-10-24,7,2020,"43",3956971,945,77,735,210,868,1.94593288654377,5.30708969057393,0.285714285714286
"United States","Oklahoma","OK",2020-10-25,2020-10-31,7,2020,"44",3956971,1025,92,749,276,933,2.32501072158477,6.9750321647543,0.36849132176235
"United States","Oklahoma","OK",2020-11-01,2020-11-07,7,2020,"45",3956971,1028,92,751,277,936,2.32501072158477,7.0003040204237,0.36884154460719
"United States","Oklahoma","OK",2020-11-08,2020-11-14,7,2020,"46",3956971,1065,87,758,307,978,2.19865144323777,7.75845969050569,0.405013192612137
"United States","Oklahoma","OK",2020-11-15,2020-11-21,7,2020,"47",3956971,1148,87,771,377,1061,2.19865144323777,9.52748958736367,0.488975356679637
"United States","Oklahoma","OK",2020-11-22,2020-11-28,7,2020,"48",3956971,1148,114,777,371,1034,2.88099154631156,9.37585845334727,0.477477477477477
"United States","Oklahoma","OK",2020-11-29,2020-12-05,7,2020,"49",3956971,1321,157,773,548,1164,3.96768134009574,13.848976906831,0.708926261319534
"United States","Oklahoma","OK",2020-12-06,2020-12-12,7,2020,"50",3956971,1212,168,786,426,1044,4.24567175245914,10.7658105151643,0.541984732824427
"United States","Oklahoma","OK",2020-12-13,2020-12-19,7,2020,"51",3956971,1281,147,795,486,1134,3.71496278340175,12.2821218553282,0.611320754716981
"United States","Oklahoma","OK",2020-12-20,2020-12-26,7,2020,"52",3956971,1272,168,791,481,1104,4.24567175245914,12.1557625769812,0.608091024020228
"United States","Oklahoma","OK",2020-12-27,2021-01-02,7,2020,"53",3956971,1337,170,804,533,1167,4.29621546379794,13.46989907179,0.662935323383085
"United States","Oklahoma","OK",2021-01-03,2021-01-09,7,2021,"1",3956971,1257,211,826,431,1046,5.33236154624333,10.8921697935112,0.521791767554479
"United States","Oklahoma","OK",2021-01-10,2021-01-16,7,2021,"2",3956971,1301,214,847,454,1087,5.40817711325152,11.4734224739074,0.536009445100354
"United States","Oklahoma","OK",2021-01-17,2021-01-23,7,2021,"3",3956971,1306,279,864,442,1027,7.0508477317625,11.1701602058746,0.511574074074074
"United States","Oklahoma","OK",2021-01-24,2021-01-30,7,2021,"4",3956971,1178,273,867,311,905,6.8992165977461,7.85954711318329,0.358708189158016
"United States","Oklahoma","OK",2021-01-31,2021-02-06,7,2021,"5",3956971,1060,257,865,195,803,6.49486690703571,4.92801185553293,0.225433526011561
"United States","Oklahoma","OK",2021-02-07,2021-02-13,7,2021,"6",3956971,992,233,845,147,759,5.88834237097012,3.71496278340175,0.17396449704142
"United States","Oklahoma","OK",2021-02-14,2021-02-20,7,2021,"7",3956971,1018,161,841,177,857,4.06876876277334,4.47311845348374,0.210463733650416
"United States","Oklahoma","OK",2021-02-21,2021-02-27,7,2021,"8",3956971,923,224,830,93,699,5.66089566994552,2.35028257725417,0.112048192771084
"United States","Oklahoma","OK",2021-02-28,2021-03-06,7,2021,"9",3956971,884,156,825,59,728,3.94240948442635,1.49103948449458,0.0715151515151515
"United States","Oklahoma","OK",2021-03-07,2021-03-13,7,2021,"10",3956971,847,167,812,35,680,4.22039989678974,0.884514948428988,0.0431034482758621
"United States","Oklahoma","OK",2021-03-14,2021-03-20,7,2021,"11",3956971,773,86,796,-23,687,2.17337958756837,-0.581252680396192,-0.0288944723618091
"United States","Oklahoma","OK",2021-03-21,2021-03-27,7,2021,"12",3956971,831,62,781,50,769,1.56685505150278,1.26359278346998,0.0640204865556979
"United States","Oklahoma","OK",2021-03-28,2021-04-03,7,2021,"13",3956971,781,103,756,25,678,2.60300113394816,0.631796391734991,0.033068783068783
"United States","Oklahoma","OK",2021-04-04,2021-04-10,7,2021,"14",3956971,828,1716,751,77,-888,43.3665043286898,1.94593288654377,0.102529960053262
"United States","Oklahoma","OK",2021-04-11,2021-04-17,7,2021,"15",3956971,779,28,742,37,751,0.70761195874319,0.935058659767787,0.0498652291105122
"United States","Oklahoma","OK",2021-04-18,2021-04-24,7,2021,"16",3956971,780,19,746,34,761,0.480165257718593,0.859243092759588,0.0455764075067024
"United States","Oklahoma","OK",2021-04-25,2021-05-01,7,2021,"17",3956971,729,72,742,-13,657,1.81957360819677,-0.328534123702195,-0.0175202156334232
"United States","Oklahoma","OK",2021-05-02,2021-05-08,7,2021,"18",3956971,817,44,737,80,773,1.11196164945358,2.02174845355197,0.108548168249661
"United States","Oklahoma","OK",2021-05-09,2021-05-15,7,2021,"19",3956971,766,46,741,25,720,1.16250536079238,0.631796391734991,0.0337381916329285
"United States","Oklahoma","OK",2021-05-16,2021-05-22,7,2021,"20",3956971,771,40,732,39,731,1.01087422677599,0.985602371106586,0.0532786885245902
"United States","Oklahoma","OK",2021-05-23,2021-05-29,7,2021,"21",3956971,739,373,708,31,366,9.42640216468607,0.783427525751389,0.0437853107344632
"United States","Oklahoma","OK",2021-05-30,2021-06-05,7,2021,"22",3956971,736,25,716,20,711,0.631796391734991,0.505437113387993,0.0279329608938548
"United States","Oklahoma","OK",2021-06-06,2021-06-12,7,2021,"23",3956971,797,9,714,83,788,0.227446701024597,2.09756402056017,0.11624649859944
"United States","Oklahoma","OK",2021-06-13,2021-06-19,7,2021,"24",3956971,779,29,713,66,750,0.73288381441259,1.66794247418038,0.0925666199158486
"United States","Oklahoma","OK",2021-06-20,2021-06-26,7,2021,"25",3956971,703,30,718,-15,673,0.758155670081989,-0.379077835040995,-0.020891364902507
"United States","Oklahoma","OK",2021-06-27,2021-07-03,7,2021,"26",3956971,632,4,711,-79,628,0.101087422677599,-1.99647659788257,-0.111111111111111
"United States","Oklahoma","OK",2021-07-04,2021-07-10,7,2021,"27",3956971,481,18,708,-227,463,0.454893402049194,-5.73671123695372,-0.320621468926554
"United States","Oregon","OR",2019-12-29,2020-01-04,7,2020,"1",4217737,737,0,805,-68,737,0,-1.6122389802873,-0.084472049689441
"United States","Oregon","OR",2020-01-05,2020-01-11,7,2020,"2",4217737,764,0,805,-41,764,0,-0.972085267526164,-0.0509316770186335
"United States","Oregon","OR",2020-01-12,2020-01-18,7,2020,"3",4217737,769,0,794,-25,769,0,-0.592734919223271,-0.0314861460957179
"United States","Oregon","OR",2020-01-19,2020-01-25,7,2020,"4",4217737,745,0,770,-25,745,0,-0.592734919223271,-0.0324675324675324
"United States","Oregon","OR",2020-01-26,2020-02-01,7,2020,"5",4217737,728,0,745,-17,728,0,-0.403059745071824,-0.0228187919463088
"United States","Oregon","OR",2020-02-02,2020-02-08,7,2020,"6",4217737,727,0,724,3,727,0,0.0711281903067925,0.0041436464088398
"United States","Oregon","OR",2020-02-09,2020-02-15,7,2020,"7",4217737,783,0,716,67,783,0,1.58852958351837,0.0935754189944134
"United States","Oregon","OR",2020-02-16,2020-02-22,7,2020,"8",4217737,733,0,721,12,733,0,0.28451276122717,0.0166435506241331
"United States","Oregon","OR",2020-02-23,2020-02-29,7,2020,"9",4217737,735,0,726,9,735,0,0.213384570920377,0.0123966942148761
"United States","Oregon","OR",2020-03-01,2020-03-07,7,2020,"10",4217737,788,0,734,54,788,0,1.28030742552226,0.0735694822888284
"United States","Oregon","OR",2020-03-08,2020-03-14,7,2020,"11",4217737,746,1,726,20,745,0.0237093967689308,0.474187935378617,0.0275482093663912
"United States","Oregon","OR",2020-03-15,2020-03-21,7,2020,"12",4217737,775,3,720,55,772,0.0711281903067925,1.3040168222912,0.0763888888888888
"United States","Oregon","OR",2020-03-22,2020-03-28,7,2020,"13",4217737,768,9,713,55,759,0.213384570920377,1.3040168222912,0.0771388499298737
"United States","Oregon","OR",2020-03-29,2020-04-04,7,2020,"14",4217737,778,13,696,82,765,0.308222157996101,1.94417053505233,0.117816091954023
"United States","Oregon","OR",2020-04-05,2020-04-11,7,2020,"15",4217737,769,25,700,69,744,0.592734919223271,1.63594837705623,0.0985714285714285
"United States","Oregon","OR",2020-04-12,2020-04-18,7,2020,"16",4217737,765,21,688,77,744,0.497897332147547,1.82562355120767,0.111918604651163
"United States","Oregon","OR",2020-04-19,2020-04-25,7,2020,"17",4217737,770,15,678,92,755,0.355640951533962,2.18126450274164,0.135693215339233
"United States","Oregon","OR",2020-04-26,2020-05-02,7,2020,"18",4217737,714,22,677,37,692,0.521606728916478,0.877247680450441,0.0546528803545052
"United States","Oregon","OR",2020-05-03,2020-05-09,7,2020,"19",4217737,703,18,675,28,685,0.426769141840755,0.663863109530063,0.0414814814814815
"United States","Oregon","OR",2020-05-10,2020-05-16,7,2020,"20",4217737,716,10,673,43,706,0.237093967689308,1.01950406106403,0.0638930163447251
"United States","Oregon","OR",2020-05-17,2020-05-23,7,2020,"21",4217737,744,10,665,79,734,0.237093967689308,1.87304234474554,0.118796992481203
"United States","Oregon","OR",2020-05-24,2020-05-30,7,2020,"22",4217737,748,6,657,91,742,0.142256380613585,2.15755510597271,0.138508371385084
"United States","Oregon","OR",2020-05-31,2020-06-06,7,2020,"23",4217737,683,8,652,31,675,0.189675174151447,0.734991299836856,0.0475460122699387
"United States","Oregon","OR",2020-06-07,2020-06-13,7,2020,"24",4217737,727,13,650,77,714,0.308222157996101,1.82562355120767,0.118461538461538
"United States","Oregon","OR",2020-06-14,2020-06-20,7,2020,"25",4217737,731,15,657,74,716,0.355640951533962,1.75449536090088,0.112633181126332
"United States","Oregon","OR",2020-06-21,2020-06-27,7,2020,"26",4217737,689,14,654,35,675,0.331931554765032,0.829828886912579,0.0535168195718654
"United States","Oregon","OR",2020-06-28,2020-07-04,7,2020,"27",4217737,760,10,645,115,750,0.237093967689308,2.72658062842705,0.178294573643411
"United States","Oregon","OR",2020-07-05,2020-07-11,7,2020,"28",4217737,713,19,641,72,694,0.450478538609686,1.70707656736302,0.112324492979719
"United States","Oregon","OR",2020-07-12,2020-07-18,7,2020,"29",4217737,759,25,645,114,734,0.592734919223271,2.70287123165811,0.176744186046512
"United States","Oregon","OR",2020-07-19,2020-07-25,7,2020,"30",4217737,740,29,646,94,711,0.687572506298994,2.2286832962795,0.145510835913313
"United States","Oregon","OR",2020-07-26,2020-08-01,7,2020,"31",4217737,719,39,641,78,680,0.924666473988302,1.8493329479766,0.121684867394696
"United States","Oregon","OR",2020-08-02,2020-08-08,7,2020,"32",4217737,768,30,641,127,738,0.711281903067925,3.01109338965422,0.198127925117005
"United States","Oregon","OR",2020-08-09,2020-08-15,7,2020,"33",4217737,777,31,638,139,746,0.734991299836856,3.29560615088138,0.217868338557994
"United States","Oregon","OR",2020-08-16,2020-08-22,7,2020,"34",4217737,789,31,632,157,758,0.734991299836856,3.72237529272214,0.248417721518987
"United States","Oregon","OR",2020-08-23,2020-08-29,7,2020,"35",4217737,749,38,631,118,711,0.900957077219371,2.79770881873384,0.187004754358162
"United States","Oregon","OR",2020-08-30,2020-09-05,7,2020,"36",4217737,707,25,618,89,682,0.592734919223271,2.11013631243484,0.144012944983819
"United States","Oregon","OR",2020-09-06,2020-09-12,7,2020,"37",4217737,737,25,618,119,712,0.592734919223271,2.82141821550277,0.192556634304207
"United States","Oregon","OR",2020-09-13,2020-09-19,7,2020,"38",4217737,790,19,621,169,771,0.450478538609686,4.00688805394931,0.272141706924316
"United States","Oregon","OR",2020-09-20,2020-09-26,7,2020,"39",4217737,730,19,634,96,711,0.450478538609686,2.27610208981736,0.151419558359621
"United States","Oregon","OR",2020-09-27,2020-10-03,7,2020,"40",4217737,733,20,651,82,713,0.474187935378617,1.94417053505233,0.125960061443932
"United States","Oregon","OR",2020-10-04,2020-10-10,7,2020,"41",4217737,761,34,668,93,727,0.806119490143648,2.20497389951057,0.139221556886228
"United States","Oregon","OR",2020-10-11,2020-10-17,7,2020,"42",4217737,713,23,661,52,690,0.545316125685409,1.2328886319844,0.0786686838124055
"United States","Oregon","OR",2020-10-18,2020-10-24,7,2020,"43",4217737,763,33,673,90,730,0.782410093374717,2.13384570920377,0.133729569093611
"United States","Oregon","OR",2020-10-25,2020-10-31,7,2020,"44",4217737,782,35,677,105,747,0.829828886912579,2.48948666073774,0.155096011816839
"United States","Oregon","OR",2020-11-01,2020-11-07,7,2020,"45",4217737,835,41,679,156,794,0.972085267526164,3.69866589595321,0.229749631811488
"United States","Oregon","OR",2020-11-08,2020-11-14,7,2020,"46",4217737,838,30,686,152,808,0.711281903067925,3.60382830887749,0.221574344023324
"United States","Oregon","OR",2020-11-15,2020-11-21,7,2020,"47",4217737,835,60,696,139,775,1.42256380613585,3.29560615088138,0.199712643678161
"United States","Oregon","OR",2020-11-22,2020-11-28,7,2020,"48",4217737,880,77,683,197,803,1.82562355120767,4.67075116347937,0.288433382137628
"United States","Oregon","OR",2020-11-29,2020-12-05,7,2020,"49",4217737,936,131,691,245,805,3.10593097672994,5.80880220838805,0.354558610709117
"United States","Oregon","OR",2020-12-06,2020-12-12,7,2020,"50",4217737,941,110,698,243,831,2.60803364458239,5.76138341485019,0.348137535816619
"United States","Oregon","OR",2020-12-13,2020-12-19,7,2020,"51",4217737,979,165,723,256,814,3.91205046687359,6.06960557284629,0.354080221300138
"United States","Oregon","OR",2020-12-20,2020-12-26,7,2020,"52",4217737,878,113,749,129,765,2.67916183488918,3.05851218319208,0.172229639519359
"United States","Oregon","OR",2020-12-27,2021-01-02,7,2020,"53",4217737,904,62,777,127,842,1.46998259967371,3.01109338965422,0.163449163449163
"United States","Oregon","OR",2021-01-03,2021-01-09,7,2021,"1",4217737,885,98,786,99,787,2.32352088335522,2.34723028012415,0.125954198473282
"United States","Oregon","OR",2021-01-10,2021-01-16,7,2021,"2",4217737,888,183,787,101,705,4.33881960871434,2.39464907366201,0.128335451080051
"United States","Oregon","OR",2021-01-17,2021-01-23,7,2021,"3",4217737,852,107,782,70,745,2.5369054542756,1.65965777382516,0.0895140664961638
"United States","Oregon","OR",2021-01-24,2021-01-30,7,2021,"4",4217737,842,73,769,73,769,1.73078596413195,1.73078596413195,0.0949284785435631
"United States","Oregon","OR",2021-01-31,2021-02-06,7,2021,"5",4217737,842,64,755,87,778,1.51740139321157,2.06271751889698,0.11523178807947
"United States","Oregon","OR",2021-02-07,2021-02-13,7,2021,"6",4217737,798,92,749,49,706,2.18126450274164,1.16176044167761,0.0654205607476634
"United States","Oregon","OR",2021-02-14,2021-02-20,7,2021,"7",4217737,820,55,758,62,765,1.3040168222912,1.46998259967371,0.0817941952506596
"United States","Oregon","OR",2021-02-21,2021-02-27,7,2021,"8",4217737,807,57,765,42,750,1.35143561582906,0.995794664295095,0.0549019607843138
"United States","Oregon","OR",2021-02-28,2021-03-06,7,2021,"9",4217737,798,87,775,23,711,2.06271751889698,0.545316125685409,0.0296774193548388
"United States","Oregon","OR",2021-03-07,2021-03-13,7,2021,"10",4217737,785,26,776,9,759,0.616444315992202,0.213384570920377,0.0115979381443299
"United States","Oregon","OR",2021-03-14,2021-03-20,7,2021,"11",4217737,832,38,772,60,794,0.900957077219371,1.42256380613585,0.0777202072538861
"United States","Oregon","OR",2021-03-21,2021-03-27,7,2021,"12",4217737,808,16,767,41,792,0.379350348302893,0.972085267526164,0.0534550195567145
"United States","Oregon","OR",2021-03-28,2021-04-03,7,2021,"13",4217737,816,12,766,50,804,0.28451276122717,1.18546983844654,0.0652741514360313
"United States","Oregon","OR",2021-04-04,2021-04-10,7,2021,"14",4217737,787,55,750,37,732,1.3040168222912,0.877247680450441,0.0493333333333332
"United States","Oregon","OR",2021-04-11,2021-04-17,7,2021,"15",4217737,746,17,740,6,729,0.403059745071824,0.142256380613585,0.00810810810810803
"United States","Oregon","OR",2021-04-18,2021-04-24,7,2021,"16",4217737,795,19,733,62,776,0.450478538609686,1.46998259967371,0.0845839017735335
"United States","Oregon","OR",2021-04-25,2021-05-01,7,2021,"17",4217737,776,19,729,47,757,0.450478538609686,1.11434164813975,0.0644718792866941
"United States","Oregon","OR",2021-05-02,2021-05-08,7,2021,"18",4217737,773,27,727,46,746,0.640153712761132,1.09063225137082,0.0632737276478679
"United States","Oregon","OR",2021-05-09,2021-05-15,7,2021,"19",4217737,808,60,727,81,748,1.42256380613585,1.9204611382834,0.111416781292985
"United States","Oregon","OR",2021-05-16,2021-05-22,7,2021,"20",4217737,816,31,725,91,785,0.734991299836856,2.15755510597271,0.12551724137931
"United States","Oregon","OR",2021-05-23,2021-05-29,7,2021,"21",4217737,772,52,719,53,720,1.2328886319844,1.25659802875333,0.0737134909596662
"United States","Oregon","OR",2021-05-30,2021-06-05,7,2021,"22",4217737,789,21,728,61,768,0.497897332147547,1.44627320290478,0.0837912087912087
"United States","Oregon","OR",2021-06-06,2021-06-12,7,2021,"23",4217737,771,40,724,47,731,0.948375870757233,1.11434164813975,0.0649171270718232
"United States","Oregon","OR",2021-06-13,2021-06-19,7,2021,"24",4217737,749,24,721,28,725,0.56902552245434,0.663863109530063,0.0388349514563107
"United States","Oregon","OR",2021-06-20,2021-06-26,7,2021,"25",4217737,715,11,719,-4,704,0.260803364458239,-0.0948375870757233,-0.00556328233657855
"United States","Oregon","OR",2021-06-27,2021-07-03,7,2021,"26",4217737,787,20,721,66,767,0.474187935378617,1.56482018674943,0.0915395284327323
"United States","Oregon","OR",2021-07-04,2021-07-10,7,2021,"27",4217737,589,11,711,-122,578,0.260803364458239,-2.89254640580956,-0.171589310829817
"United States","Pennsylvania","PA",2019-12-29,2020-01-04,7,2020,"1",12801989,2785,0,2974,-189,2785,0,-1.47633309167818,-0.0635507733691997
"United States","Pennsylvania","PA",2020-01-05,2020-01-11,7,2020,"2",12801989,2849,0,3026,-177,2849,0,-1.38259765728591,-0.0584930601454065
"United States","Pennsylvania","PA",2020-01-12,2020-01-18,7,2020,"3",12801989,2862,0,3008,-146,2862,0,-1.14044778510589,-0.0485372340425532
"United States","Pennsylvania","PA",2020-01-19,2020-01-25,7,2020,"4",12801989,2795,0,2988,-193,2795,0,-1.5075782364756,-0.0645917001338688
"United States","Pennsylvania","PA",2020-01-26,2020-02-01,7,2020,"5",12801989,2810,0,2972,-162,2810,0,-1.26542836429558,-0.0545087483176312
"United States","Pennsylvania","PA",2020-02-02,2020-02-08,7,2020,"6",12801989,2787,0,2940,-153,2787,0,-1.19512678850138,-0.0520408163265306
"United States","Pennsylvania","PA",2020-02-09,2020-02-15,7,2020,"7",12801989,2811,0,2905,-94,2811,0,-0.73426090273941,-0.0323580034423407
"United States","Pennsylvania","PA",2020-02-16,2020-02-22,7,2020,"8",12801989,2704,0,2884,-180,2704,0,-1.40603151588398,-0.0624133148404993
"United States","Pennsylvania","PA",2020-02-23,2020-02-29,7,2020,"9",12801989,2774,0,2831,-57,2774,0,-0.445243313363259,-0.0201342281879194
"United States","Pennsylvania","PA",2020-03-01,2020-03-07,7,2020,"10",12801989,2787,0,2820,-33,2787,0,-0.257772444578729,-0.0117021276595745
"United States","Pennsylvania","PA",2020-03-08,2020-03-14,7,2020,"11",12801989,2833,0,2793,40,2833,0,0.312451447974217,0.0143215180809166
"United States","Pennsylvania","PA",2020-03-15,2020-03-21,7,2020,"12",12801989,2603,2,2775,-172,2601,0.0156225723987109,-1.34354122628913,-0.061981981981982
"United States","Pennsylvania","PA",2020-03-22,2020-03-28,7,2020,"13",12801989,2735,32,2748,-13,2703,0.249961158379374,-0.101546720591621,-0.00473071324599705
"United States","Pennsylvania","PA",2020-03-29,2020-04-04,7,2020,"14",12801989,3004,102,2727,277,2902,0.796751192334254,2.16372627722145,0.101576824349102
"United States","Pennsylvania","PA",2020-04-05,2020-04-11,7,2020,"15",12801989,3453,355,2683,770,3098,2.77300660077118,6.01469037350368,0.286992172940738
"United States","Pennsylvania","PA",2020-04-12,2020-04-18,7,2020,"16",12801989,3743,345,2656,1087,3398,2.69489373877762,8.49086809869935,0.409262048192771
"United States","Pennsylvania","PA",2020-04-19,2020-04-25,7,2020,"17",12801989,3823,700,2602,1221,3123,5.4679003395488,9.53758044941298,0.469254419677171
"United States","Pennsylvania","PA",2020-04-26,2020-05-02,7,2020,"18",12801989,3564,881,2554,1010,2683,6.88174314163213,7.88939906134898,0.395458104933438
"United States","Pennsylvania","PA",2020-05-03,2020-05-09,7,2020,"19",12801989,3439,1252,2515,924,2187,9.779730321593,7.21762844820442,0.367395626242545
"United States","Pennsylvania","PA",2020-05-10,2020-05-16,7,2020,"20",12801989,3284,534,2473,811,2750,4.1712268304558,6.33495310767725,0.327941771128184
"United States","Pennsylvania","PA",2020-05-17,2020-05-23,7,2020,"21",12801989,2977,893,2447,530,2084,6.9754785760244,4.13998168565838,0.21659174499387
"United States","Pennsylvania","PA",2020-05-24,2020-05-30,7,2020,"22",12801989,2792,440,2453,339,2352,3.43696592771639,2.64802602158149,0.13819812474521
"United States","Pennsylvania","PA",2020-05-31,2020-06-06,7,2020,"23",12801989,2730,394,2465,265,2336,3.07764676254604,2.06999084282919,0.107505070993915
"United States","Pennsylvania","PA",2020-06-07,2020-06-13,7,2020,"24",12801989,2573,280,2442,131,2293,2.18716013581952,1.02327849211556,0.0536445536445536
"United States","Pennsylvania","PA",2020-06-14,2020-06-20,7,2020,"25",12801989,2624,209,2441,183,2415,1.63255881566528,1.42946537448204,0.0749692748873412
"United States","Pennsylvania","PA",2020-06-21,2020-06-27,7,2020,"26",12801989,2561,183,2409,152,2378,1.42946537448204,1.18731550230203,0.0630967206309672
"United States","Pennsylvania","PA",2020-06-28,2020-07-04,7,2020,"27",12801989,2595,147,2388,207,2448,1.14825907130525,1.61693624326657,0.0866834170854272
"United States","Pennsylvania","PA",2020-07-05,2020-07-11,7,2020,"28",12801989,2677,148,2381,296,2529,1.1560703575046,2.31214071500921,0.124317513649727
"United States","Pennsylvania","PA",2020-07-12,2020-07-18,7,2020,"29",12801989,2560,110,2346,214,2450,0.859241481929097,1.67161524666206,0.0912190963341859
"United States","Pennsylvania","PA",2020-07-19,2020-07-25,7,2020,"30",12801989,2535,107,2332,203,2428,0.835807623331031,1.58569109846915,0.08704974271012
"United States","Pennsylvania","PA",2020-07-26,2020-08-01,7,2020,"31",12801989,2645,90,2328,317,2555,0.703015757941989,2.47617772519567,0.136168384879725
"United States","Pennsylvania","PA",2020-08-02,2020-08-08,7,2020,"32",12801989,2540,109,2318,222,2431,0.851430195729742,1.73410553625691,0.095772217428818
"United States","Pennsylvania","PA",2020-08-09,2020-08-15,7,2020,"33",12801989,2661,152,2313,348,2509,1.18731550230203,2.71832759737569,0.150453955901427
"United States","Pennsylvania","PA",2020-08-16,2020-08-22,7,2020,"34",12801989,2634,111,2329,305,2523,0.867052768128453,2.38244229080341,0.130957492486045
"United States","Pennsylvania","PA",2020-08-23,2020-08-29,7,2020,"35",12801989,2589,95,2329,260,2494,0.742072188938766,2.03093441183241,0.111635895234006
"United States","Pennsylvania","PA",2020-08-30,2020-09-05,7,2020,"36",12801989,2604,89,2355,249,2515,0.695204471742633,1.9450102636395,0.105732484076433
"United States","Pennsylvania","PA",2020-09-06,2020-09-12,7,2020,"37",12801989,2619,77,2346,273,2542,0.601469037350368,2.13248113242403,0.116368286445013
"United States","Pennsylvania","PA",2020-09-13,2020-09-19,7,2020,"38",12801989,2618,119,2348,270,2499,0.929543057723296,2.10904727382597,0.114991482112436
"United States","Pennsylvania","PA",2020-09-20,2020-09-26,7,2020,"39",12801989,2678,147,2360,318,2531,1.14825907130525,2.48398901139503,0.134745762711864
"United States","Pennsylvania","PA",2020-09-27,2020-10-03,7,2020,"40",12801989,2681,96,2394,287,2585,0.749883475138121,2.24183913921501,0.119883040935673
"United States","Pennsylvania","PA",2020-10-04,2020-10-10,7,2020,"41",12801989,2769,73,2410,359,2696,0.570223892552946,2.8042517455686,0.14896265560166
"United States","Pennsylvania","PA",2020-10-11,2020-10-17,7,2020,"42",12801989,2669,194,2458,211,2475,1.51538952267495,1.648181388064,0.0858421480878764
"United States","Pennsylvania","PA",2020-10-18,2020-10-24,7,2020,"43",12801989,2766,188,2458,308,2578,1.46852180547882,2.40587614940147,0.125305126118796
"United States","Pennsylvania","PA",2020-10-25,2020-10-31,7,2020,"44",12801989,2758,158,2459,299,2600,1.23418321949816,2.33557457360727,0.12159414396096
"United States","Pennsylvania","PA",2020-11-01,2020-11-07,7,2020,"45",12801989,2984,203,2482,502,2781,1.58569109846915,3.92126567207643,0.202256244963739
"United States","Pennsylvania","PA",2020-11-08,2020-11-14,7,2020,"46",12801989,3123,259,2494,629,2864,2.02312312563306,4.91329901939456,0.252205292702486
"United States","Pennsylvania","PA",2020-11-15,2020-11-21,7,2020,"47",12801989,3355,415,2518,837,2940,3.2416837727325,6.53804654886049,0.332406671961875
"United States","Pennsylvania","PA",2020-11-22,2020-11-28,7,2020,"48",12801989,3659,586,2545,1114,3073,4.57741371282228,8.70177282608195,0.437721021611002
"United States","Pennsylvania","PA",2020-11-29,2020-12-05,7,2020,"49",12801989,3903,987,2576,1327,2916,7.70973947876381,10.3655767865447,0.515139751552795
"United States","Pennsylvania","PA",2020-12-06,2020-12-12,7,2020,"50",12801989,4355,1174,2595,1760,3181,9.17044999804327,13.7478637108656,0.678227360308285
"United States","Pennsylvania","PA",2020-12-13,2020-12-19,7,2020,"51",12801989,4456,1389,2628,1828,3067,10.8498765309047,14.2790311724217,0.69558599695586
"United States","Pennsylvania","PA",2020-12-20,2020-12-26,7,2020,"52",12801989,4490,1054,2663,1827,3436,8.23309565412062,14.2712198862224,0.686068343972963
"United States","Pennsylvania","PA",2020-12-27,2021-01-02,7,2020,"53",12801989,4424,1360,2687,1737,3064,10.6233492311234,13.5682041282804,0.64644585039077
"United States","Pennsylvania","PA",2021-01-03,2021-01-09,7,2021,"1",12801989,4002,1428,2741,1261,2574,11.1545166926796,9.8500318973872,0.460051076249544
"United States","Pennsylvania","PA",2021-01-10,2021-01-16,7,2021,"2",12801989,3885,1521,2793,1092,2364,11.8809663092196,8.52992452969613,0.390977443609023
"United States","Pennsylvania","PA",2021-01-17,2021-01-23,7,2021,"3",12801989,3845,1338,2805,1040,2507,10.4515009347376,8.12373764732964,0.370766488413547
"United States","Pennsylvania","PA",2021-01-24,2021-01-30,7,2021,"4",12801989,3596,1076,2803,793,2520,8.40494395050644,6.19434995608885,0.282911166607207
"United States","Pennsylvania","PA",2021-01-31,2021-02-06,7,2021,"5",12801989,3406,794,2796,610,2612,6.20216124228821,4.76488458160681,0.218168812589413
"United States","Pennsylvania","PA",2021-02-07,2021-02-13,7,2021,"6",12801989,3242,564,2759,483,2678,4.40556541643646,3.77285123428867,0.175063428778543
"United States","Pennsylvania","PA",2021-02-14,2021-02-20,7,2021,"7",12801989,3127,611,2744,383,2516,4.77269586780617,2.99172261435313,0.139577259475219
"United States","Pennsylvania","PA",2021-02-21,2021-02-27,7,2021,"8",12801989,2898,370,2737,161,2528,2.89017589376151,1.25761707809622,0.0588235294117647
"United States","Pennsylvania","PA",2021-02-28,2021-03-06,7,2021,"9",12801989,2768,381,2723,45,2387,2.97610004195442,0.351507878970994,0.0165258905618804
"United States","Pennsylvania","PA",2021-03-07,2021-03-13,7,2021,"10",12801989,2708,253,2697,11,2455,1.97625540843692,0.0859241481929097,0.00407860585836106
"United States","Pennsylvania","PA",2021-03-14,2021-03-20,7,2021,"11",12801989,2807,207,2680,127,2600,1.61693624326657,0.992033347318139,0.0473880597014926
"United States","Pennsylvania","PA",2021-03-21,2021-03-27,7,2021,"12",12801989,2695,207,2662,33,2488,1.61693624326657,0.257772444578729,0.0123966942148761
"United States","Pennsylvania","PA",2021-03-28,2021-04-03,7,2021,"13",12801989,2619,201,2646,-27,2418,1.57006852607044,-0.210904727382597,-0.0102040816326531
"United States","Pennsylvania","PA",2021-04-04,2021-04-10,7,2021,"14",12801989,2770,172,2613,157,2598,1.34354122628913,1.2263719332988,0.0600841944125525
"United States","Pennsylvania","PA",2021-04-11,2021-04-17,7,2021,"15",12801989,2839,299,2578,261,2540,2.33557457360727,2.03874569803177,0.101241272304112
"United States","Pennsylvania","PA",2021-04-18,2021-04-24,7,2021,"16",12801989,2782,277,2552,230,2505,2.16372627722145,1.79659582585175,0.0901253918495297
"United States","Pennsylvania","PA",2021-04-25,2021-05-01,7,2021,"17",12801989,2676,315,2509,167,2361,2.46055515279696,1.30448479529236,0.0665603826225587
"United States","Pennsylvania","PA",2021-05-02,2021-05-08,7,2021,"18",12801989,2723,279,2463,260,2444,2.17934884962016,2.03093441183241,0.105562322371092
"United States","Pennsylvania","PA",2021-05-09,2021-05-15,7,2021,"19",12801989,2694,192,2462,232,2502,1.49976695027624,1.81221839825046,0.0942323314378555
"United States","Pennsylvania","PA",2021-05-16,2021-05-22,7,2021,"20",12801989,2690,305,2440,250,2385,2.38244229080341,1.95282154983886,0.102459016393443
"United States","Pennsylvania","PA",2021-05-23,2021-05-29,7,2021,"21",12801989,2528,158,2438,90,2370,1.23418321949816,0.703015757941989,0.036915504511895
"United States","Pennsylvania","PA",2021-05-30,2021-06-05,7,2021,"22",12801989,2604,162,2426,178,2442,1.26542836429558,1.39040894348527,0.0733718054410553
"United States","Pennsylvania","PA",2021-06-06,2021-06-12,7,2021,"23",12801989,2404,125,2451,-47,2279,0.976410774919429,-0.367130451369705,-0.0191758465932272
"United States","Pennsylvania","PA",2021-06-13,2021-06-19,7,2021,"24",12801989,2507,86,2440,67,2421,0.671770613144567,0.523356175356814,0.0274590163934427
"United States","Pennsylvania","PA",2021-06-20,2021-06-26,7,2021,"25",12801989,2455,83,2427,28,2372,0.648336754546501,0.218716013581952,0.0115368768026369
"United States","Pennsylvania","PA",2021-06-27,2021-07-03,7,2021,"26",12801989,2439,62,2411,28,2377,0.484299744360037,0.218716013581952,0.0116134384072999
"United States","Pennsylvania","PA",2021-07-04,2021-07-10,7,2021,"27",12801989,2260,40,2399,-139,2220,0.312451447974217,-1.0857687817104,-0.0579408086702793
"United States","Rhode Island","RI",2019-12-29,2020-01-04,7,2020,"1",1059361,225,0,229,-4,225,0,-0.377586110872498,-0.017467248908297
"United States","Rhode Island","RI",2020-01-05,2020-01-11,7,2020,"2",1059361,201,0,227,-26,201,0,-2.45430972067123,-0.114537444933921
"United States","Rhode Island","RI",2020-01-12,2020-01-18,7,2020,"3",1059361,204,0,227,-23,204,0,-2.17112013751686,-0.101321585903084
"United States","Rhode Island","RI",2020-01-19,2020-01-25,7,2020,"4",1059361,199,0,225,-26,199,0,-2.45430972067123,-0.115555555555556
"United States","Rhode Island","RI",2020-01-26,2020-02-01,7,2020,"5",1059361,220,0,230,-10,220,0,-0.943965277181244,-0.0434782608695652
"United States","Rhode Island","RI",2020-02-02,2020-02-08,7,2020,"6",1059361,244,0,232,12,244,0,1.13275833261749,0.0517241379310345
"United States","Rhode Island","RI",2020-02-09,2020-02-15,7,2020,"7",1059361,183,0,231,-48,183,0,-4.53103333046997,-0.207792207792208
"United States","Rhode Island","RI",2020-02-16,2020-02-22,7,2020,"8",1059361,206,0,229,-23,206,0,-2.17112013751686,-0.100436681222707
"United States","Rhode Island","RI",2020-02-23,2020-02-29,7,2020,"9",1059361,235,0,220,15,235,0,1.41594791577187,0.0681818181818181
"United States","Rhode Island","RI",2020-03-01,2020-03-07,7,2020,"10",1059361,251,0,218,33,251,0,3.11508541469811,0.151376146788991
"United States","Rhode Island","RI",2020-03-08,2020-03-14,7,2020,"11",1059361,196,0,216,-20,196,0,-1.88793055436249,-0.0925925925925926
"United States","Rhode Island","RI",2020-03-15,2020-03-21,7,2020,"12",1059361,220,0,217,3,220,0,0.283189583154373,0.0138248847926268
"United States","Rhode Island","RI",2020-03-22,2020-03-28,7,2020,"13",1059361,200,2,210,-10,198,0.188793055436249,-0.943965277181244,-0.0476190476190477
"United States","Rhode Island","RI",2020-03-29,2020-04-04,7,2020,"14",1059361,236,13,215,21,223,1.22715486033562,1.98232708208061,0.0976744186046512
"United States","Rhode Island","RI",2020-04-05,2020-04-11,7,2020,"15",1059361,246,41,219,27,205,3.8702576364431,2.54870624838936,0.123287671232877
"United States","Rhode Island","RI",2020-04-12,2020-04-18,7,2020,"16",1059361,273,81,222,51,192,7.64611874516808,4.81422291362435,0.22972972972973
"United States","Rhode Island","RI",2020-04-19,2020-04-25,7,2020,"17",1059361,297,78,217,80,219,7.3629291620137,7.55172221744995,0.368663594470046
"United States","Rhode Island","RI",2020-04-26,2020-05-02,7,2020,"18",1059361,332,81,219,113,251,7.64611874516808,10.6668076321481,0.515981735159817
"United States","Rhode Island","RI",2020-05-03,2020-05-09,7,2020,"19",1059361,381,122,218,163,259,11.5163763816112,15.3866340180543,0.747706422018349
"United States","Rhode Island","RI",2020-05-10,2020-05-16,7,2020,"20",1059361,303,71,215,88,232,6.70215346798683,8.30689443919495,0.409302325581395
"United States","Rhode Island","RI",2020-05-17,2020-05-23,7,2020,"21",1059361,279,108,204,75,171,10.1948249935574,7.07973957885933,0.367647058823529
"United States","Rhode Island","RI",2020-05-24,2020-05-30,7,2020,"22",1059361,254,121,200,54,133,11.4219798538931,5.09741249677872,0.27
"United States","Rhode Island","RI",2020-05-31,2020-06-06,7,2020,"23",1059361,241,54,195,46,187,5.09741249677872,4.34224027503372,0.235897435897436
"United States","Rhode Island","RI",2020-06-07,2020-06-13,7,2020,"24",1059361,209,61,197,12,148,5.75818819080559,1.13275833261749,0.0609137055837563
"United States","Rhode Island","RI",2020-06-14,2020-06-20,7,2020,"25",1059361,237,61,195,42,176,5.75818819080559,3.96465416416123,0.215384615384615
"United States","Rhode Island","RI",2020-06-21,2020-06-27,7,2020,"26",1059361,200,33,193,7,167,3.11508541469811,0.660775694026871,0.0362694300518134
"United States","Rhode Island","RI",2020-06-28,2020-07-04,7,2020,"27",1059361,177,33,193,-16,144,3.11508541469811,-1.51034444348999,-0.082901554404145
"United States","Rhode Island","RI",2020-07-05,2020-07-11,7,2020,"28",1059361,190,16,192,-2,174,1.51034444348999,-0.188793055436249,-0.0104166666666666
"United States","Rhode Island","RI",2020-07-12,2020-07-18,7,2020,"29",1059361,190,14,188,2,176,1.32155138805374,0.188793055436249,0.0106382978723405
"United States","Rhode Island","RI",2020-07-19,2020-07-25,7,2020,"30",1059361,173,4,186,-13,169,0.377586110872498,-1.22715486033562,-0.0698924731182796
"United States","Rhode Island","RI",2020-07-26,2020-08-01,7,2020,"31",1059361,200,-5,185,15,205,-0.471982638590622,1.41594791577187,0.0810810810810811
"United States","Rhode Island","RI",2020-08-02,2020-08-08,7,2020,"32",1059361,209,5,185,24,204,0.471982638590622,2.26551666523499,0.12972972972973
"United States","Rhode Island","RI",2020-08-09,2020-08-15,7,2020,"33",1059361,211,7,185,26,204,0.660775694026871,2.45430972067123,0.14054054054054
"United States","Rhode Island","RI",2020-08-16,2020-08-22,7,2020,"34",1059361,198,7,192,6,191,0.660775694026871,0.566379166308747,0.03125
"United States","Rhode Island","RI",2020-08-23,2020-08-29,7,2020,"35",1059361,187,12,194,-7,175,1.13275833261749,-0.660775694026871,-0.0360824742268041
"United States","Rhode Island","RI",2020-08-30,2020-09-05,7,2020,"36",1059361,207,11,193,14,196,1.03836180489937,1.32155138805374,0.072538860103627
"United States","Rhode Island","RI",2020-09-06,2020-09-12,7,2020,"37",1059361,190,11,195,-5,179,1.03836180489937,-0.471982638590622,-0.0256410256410257
"United States","Rhode Island","RI",2020-09-13,2020-09-19,7,2020,"38",1059361,194,13,196,-2,181,1.22715486033562,-0.188793055436249,-0.0102040816326531
"United States","Rhode Island","RI",2020-09-20,2020-09-26,7,2020,"39",1059361,208,23,197,11,185,2.17112013751686,1.03836180489937,0.0558375634517767
"United States","Rhode Island","RI",2020-09-27,2020-10-03,7,2020,"40",1059361,218,14,196,22,204,1.32155138805374,2.07672360979874,0.112244897959184
"United States","Rhode Island","RI",2020-10-04,2020-10-10,7,2020,"41",1059361,214,12,200,14,202,1.13275833261749,1.32155138805374,0.0700000000000001
"United States","Rhode Island","RI",2020-10-11,2020-10-17,7,2020,"42",1059361,214,12,200,14,202,1.13275833261749,1.32155138805374,0.0700000000000001
"United States","Rhode Island","RI",2020-10-18,2020-10-24,7,2020,"43",1059361,196,23,197,-1,173,2.17112013751686,-0.0943965277181244,-0.00507614213197971
"United States","Rhode Island","RI",2020-10-25,2020-10-31,7,2020,"44",1059361,204,27,202,2,177,2.54870624838936,0.188793055436249,0.00990099009900991
"United States","Rhode Island","RI",2020-11-01,2020-11-07,7,2020,"45",1059361,228,23,202,26,205,2.17112013751686,2.45430972067123,0.128712871287129
"United States","Rhode Island","RI",2020-11-08,2020-11-14,7,2020,"46",1059361,235,24,198,37,211,2.26551666523499,3.4926715255706,0.186868686868687
"United States","Rhode Island","RI",2020-11-15,2020-11-21,7,2020,"47",1059361,226,31,198,28,195,2.92629235926186,2.64310277610748,0.141414141414141
"United States","Rhode Island","RI",2020-11-22,2020-11-28,7,2020,"48",1059361,268,33,205,63,235,3.11508541469811,5.94698124624184,0.307317073170732
"United States","Rhode Island","RI",2020-11-29,2020-12-05,7,2020,"49",1059361,289,62,207,82,227,5.85258471852371,7.7405152728862,0.396135265700483
"United States","Rhode Island","RI",2020-12-06,2020-12-12,7,2020,"50",1059361,325,74,214,111,251,6.98534305114121,10.4780145767118,0.518691588785047
"United States","Rhode Island","RI",2020-12-13,2020-12-19,7,2020,"51",1059361,329,98,216,113,231,9.25085971637619,10.6668076321481,0.523148148148148
"United States","Rhode Island","RI",2020-12-20,2020-12-26,7,2020,"52",1059361,302,116,218,84,186,10.9499972153024,7.92930832832245,0.385321100917431
"United States","Rhode Island","RI",2020-12-27,2021-01-02,7,2020,"53",1059361,284,85,221,63,199,8.02370485604058,5.94698124624184,0.285067873303168
"United States","Rhode Island","RI",2021-01-03,2021-01-09,7,2021,"1",1059361,295,132,218,77,163,12.4603416587924,7.26853263429558,0.353211009174312
"United States","Rhode Island","RI",2021-01-10,2021-01-16,7,2021,"2",1059361,295,71,221,74,224,6.70215346798683,6.98534305114121,0.334841628959276
"United States","Rhode Island","RI",2021-01-17,2021-01-23,7,2021,"3",1059361,309,88,222,87,221,8.30689443919495,8.21249791147682,0.391891891891892
"United States","Rhode Island","RI",2021-01-24,2021-01-30,7,2021,"4",1059361,268,73,223,45,195,6.89094652342308,4.2478437473156,0.201793721973094
"United States","Rhode Island","RI",2021-01-31,2021-02-06,7,2021,"5",1059361,274,74,220,54,200,6.98534305114121,5.09741249677872,0.245454545454545
"United States","Rhode Island","RI",2021-02-07,2021-02-13,7,2021,"6",1059361,253,67,218,35,186,6.32456735711434,3.30387847013435,0.160550458715596
"United States","Rhode Island","RI",2021-02-14,2021-02-20,7,2021,"7",1059361,226,94,217,9,132,8.87327360550369,0.84956874946312,0.0414746543778801
"United States","Rhode Island","RI",2021-02-21,2021-02-27,7,2021,"8",1059361,229,137,216,13,92,12.932324297383,1.22715486033562,0.0601851851851851
"United States","Rhode Island","RI",2021-02-28,2021-03-06,7,2021,"9",1059361,231,55,213,18,176,5.19180902449684,1.69913749892624,0.0845070422535212
"United States","Rhode Island","RI",2021-03-07,2021-03-13,7,2021,"10",1059361,244,33,211,33,211,3.11508541469811,3.11508541469811,0.156398104265403
"United States","Rhode Island","RI",2021-03-14,2021-03-20,7,2021,"11",1059361,213,26,213,0,187,2.45430972067123,0,0
"United States","Rhode Island","RI",2021-03-21,2021-03-27,7,2021,"12",1059361,212,32,213,-1,180,3.02068888697998,-0.0943965277181244,-0.00469483568075113
"United States","Rhode Island","RI",2021-03-28,2021-04-03,7,2021,"13",1059361,198,36,207,-9,162,3.39827499785248,-0.84956874946312,-0.0434782608695652
"United States","Rhode Island","RI",2021-04-04,2021-04-10,7,2021,"14",1059361,220,8,208,12,212,0.755172221744995,1.13275833261749,0.0576923076923077
"United States","Rhode Island","RI",2021-04-11,2021-04-17,7,2021,"15",1059361,194,9,212,-18,185,0.84956874946312,-1.69913749892624,-0.0849056603773585
"United States","Rhode Island","RI",2021-04-18,2021-04-24,7,2021,"16",1059361,202,13,217,-15,189,1.22715486033562,-1.41594791577187,-0.0691244239631337
"United States","Rhode Island","RI",2021-04-25,2021-05-01,7,2021,"17",1059361,210,11,215,-5,199,1.03836180489937,-0.471982638590622,-0.0232558139534884
"United States","Rhode Island","RI",2021-05-02,2021-05-08,7,2021,"18",1059361,218,19,216,2,199,1.79353402664436,0.188793055436249,0.0092592592592593
"United States","Rhode Island","RI",2021-05-09,2021-05-15,7,2021,"19",1059361,244,10,214,30,234,0.943965277181244,2.83189583154373,0.14018691588785
"United States","Rhode Island","RI",2021-05-16,2021-05-22,7,2021,"20",1059361,193,4,206,-13,189,0.377586110872498,-1.22715486033562,-0.0631067961165048
"United States","Rhode Island","RI",2021-05-23,2021-05-29,7,2021,"21",1059361,192,4,200,-8,188,0.377586110872498,-0.755172221744995,-0.04
"United States","Rhode Island","RI",2021-05-30,2021-06-05,7,2021,"22",1059361,190,9,199,-9,181,0.84956874946312,-0.84956874946312,-0.0452261306532663
"United States","Rhode Island","RI",2021-06-06,2021-06-12,7,2021,"23",1059361,205,5,196,9,200,0.471982638590622,0.84956874946312,0.0459183673469388
"United States","Rhode Island","RI",2021-06-13,2021-06-19,7,2021,"24",1059361,176,2,202,-26,174,0.188793055436249,-2.45430972067123,-0.128712871287129
"United States","Rhode Island","RI",2021-06-20,2021-06-26,7,2021,"25",1059361,191,4,200,-9,187,0.377586110872498,-0.84956874946312,-0.045
"United States","Rhode Island","RI",2021-06-27,2021-07-03,7,2021,"26",1059361,164,2,201,-37,162,0.188793055436249,-3.4926715255706,-0.18407960199005
"United States","Rhode Island","RI",2021-07-04,2021-07-10,7,2021,"27",1059361,112,0,199,-87,112,0,-8.21249791147682,-0.437185929648241
"United States","South Carolina","SC",2019-12-29,2020-01-04,7,2020,"1",5148714,1087,0,1108,-21,1087,0,-0.407868838704189,-0.0189530685920578
"United States","South Carolina","SC",2020-01-05,2020-01-11,7,2020,"2",5148714,1081,0,1106,-25,1081,0,-0.485558141314511,-0.0226039783001808
"United States","South Carolina","SC",2020-01-12,2020-01-18,7,2020,"3",5148714,1048,0,1124,-76,1048,0,-1.47609674959611,-0.0676156583629893
"United States","South Carolina","SC",2020-01-19,2020-01-25,7,2020,"4",5148714,1033,0,1121,-88,1033,0,-1.70916465742708,-0.0785013380909901
"United States","South Carolina","SC",2020-01-26,2020-02-01,7,2020,"5",5148714,1032,0,1113,-81,1032,0,-1.57320837785901,-0.0727762803234502
"United States","South Carolina","SC",2020-02-02,2020-02-08,7,2020,"6",5148714,1096,0,1082,14,1096,0,0.271912559136126,0.0129390018484288
"United States","South Carolina","SC",2020-02-09,2020-02-15,7,2020,"7",5148714,1003,0,1062,-59,1003,0,-1.14591721350225,-0.0555555555555556
"United States","South Carolina","SC",2020-02-16,2020-02-22,7,2020,"8",5148714,1035,0,1063,-28,1035,0,-0.543825118272252,-0.026340545625588
"United States","South Carolina","SC",2020-02-23,2020-02-29,7,2020,"9",5148714,1044,0,1052,-8,1044,0,-0.155378605220643,-0.00760456273764254
"United States","South Carolina","SC",2020-03-01,2020-03-07,7,2020,"10",5148714,1133,0,1045,88,1133,0,1.70916465742708,0.0842105263157895
"United States","South Carolina","SC",2020-03-08,2020-03-14,7,2020,"11",5148714,1103,0,1041,62,1103,0,1.20418419045999,0.0595581171950048
"United States","South Carolina","SC",2020-03-15,2020-03-21,7,2020,"12",5148714,1067,3,1030,37,1064,0.0582669769577413,0.718626049145476,0.0359223300970875
"United States","South Carolina","SC",2020-03-22,2020-03-28,7,2020,"13",5148714,1039,12,1038,1,1027,0.233067907830965,0.0194223256525804,0.000963391136801439
"United States","South Carolina","SC",2020-03-29,2020-04-04,7,2020,"14",5148714,1048,25,1023,25,1023,0.485558141314511,0.485558141314511,0.0244379276637341
"United States","South Carolina","SC",2020-04-05,2020-04-11,7,2020,"15",5148714,1138,32,1015,123,1106,0.621514420882574,2.38894605526739,0.121182266009852
"United States","South Carolina","SC",2020-04-12,2020-04-18,7,2020,"16",5148714,1049,47,1001,48,1002,0.91284930567128,0.932271631323861,0.0479520479520479
"United States","South Carolina","SC",2020-04-19,2020-04-25,7,2020,"17",5148714,1023,47,981,42,976,0.91284930567128,0.815737677408378,0.0428134556574924
"United States","South Carolina","SC",2020-04-26,2020-05-02,7,2020,"18",5148714,1033,101,970,63,932,1.96165489091062,1.22360651611257,0.0649484536082474
"United States","South Carolina","SC",2020-05-03,2020-05-09,7,2020,"19",5148714,1060,62,959,101,998,1.20418419045999,1.96165489091062,0.105318039624609
"United States","South Carolina","SC",2020-05-10,2020-05-16,7,2020,"20",5148714,1110,51,956,154,1059,0.990538608281602,2.99103815049739,0.161087866108787
"United States","South Carolina","SC",2020-05-17,2020-05-23,7,2020,"21",5148714,1046,45,951,95,1001,0.874004654366119,1.84512093699514,0.099894847528917
"United States","South Carolina","SC",2020-05-24,2020-05-30,7,2020,"22",5148714,1048,58,952,96,990,1.12649488784967,1.86454326264772,0.100840336134454
"United States","South Carolina","SC",2020-05-31,2020-06-06,7,2020,"23",5148714,1037,62,955,82,975,1.20418419045999,1.5926307035116,0.0858638743455498
"United States","South Carolina","SC",2020-06-07,2020-06-13,7,2020,"24",5148714,1079,53,951,128,1026,1.02938325958676,2.4860576835303,0.13459516298633
"United States","South Carolina","SC",2020-06-14,2020-06-20,7,2020,"25",5148714,1052,45,940,112,1007,0.874004654366119,2.17530047308901,0.119148936170213
"United States","South Carolina","SC",2020-06-21,2020-06-27,7,2020,"26",5148714,1099,64,946,153,1035,1.24302884176515,2.97161582484481,0.161733615221987
"United States","South Carolina","SC",2020-06-28,2020-07-04,7,2020,"27",5148714,1197,99,940,257,1098,1.92281023960546,4.99153769271317,0.273404255319149
"United States","South Carolina","SC",2020-07-05,2020-07-11,7,2020,"28",5148714,1218,134,944,274,1084,2.60259163744578,5.32171722880704,0.290254237288136
"United States","South Carolina","SC",2020-07-12,2020-07-18,7,2020,"29",5148714,1335,177,947,388,1158,3.43775164050674,7.53586235320121,0.409714889123548
"United States","South Carolina","SC",2020-07-19,2020-07-25,7,2020,"30",5148714,1352,295,949,403,1057,5.72958606751123,7.82719723798991,0.424657534246575
"United States","South Carolina","SC",2020-07-26,2020-08-01,7,2020,"31",5148714,1329,271,947,382,1058,5.2634502518493,7.41932839928573,0.40337909186906
"United States","South Carolina","SC",2020-08-02,2020-08-08,7,2020,"32",5148714,1368,233,937,431,1135,4.52540187705124,8.37102235626217,0.459978655282818
"United States","South Carolina","SC",2020-08-09,2020-08-15,7,2020,"33",5148714,1319,344,932,387,975,6.68128002448767,7.51644002754863,0.415236051502146
"United States","South Carolina","SC",2020-08-16,2020-08-22,7,2020,"34",5148714,1181,233,922,259,948,4.52540187705124,5.03038234401833,0.280911062906724
"United States","South Carolina","SC",2020-08-23,2020-08-29,7,2020,"35",5148714,1240,205,920,320,1035,3.98157675877899,6.21514420882574,0.347826086956522
"United States","South Carolina","SC",2020-08-30,2020-09-05,7,2020,"36",5148714,1243,179,924,319,1064,3.4765962918119,6.19572188317316,0.345238095238095
"United States","South Carolina","SC",2020-09-06,2020-09-12,7,2020,"37",5148714,1186,163,936,250,1023,3.16583908137061,4.85558141314511,0.267094017094017
"United States","South Carolina","SC",2020-09-13,2020-09-19,7,2020,"38",5148714,1142,148,945,197,994,2.8745041965819,3.82619815355834,0.208465608465608
"United States","South Carolina","SC",2020-09-20,2020-09-26,7,2020,"39",5148714,1152,135,946,206,1017,2.62201396309836,4.00099908443157,0.217758985200846
"United States","South Carolina","SC",2020-09-27,2020-10-03,7,2020,"40",5148714,1142,119,949,193,1023,2.31125675265707,3.74850885094802,0.203371970495258
"United States","South Carolina","SC",2020-10-04,2020-10-10,7,2020,"41",5148714,1133,109,945,188,1024,2.11703349613127,3.65139722268512,0.198941798941799
"United States","South Carolina","SC",2020-10-11,2020-10-17,7,2020,"42",5148714,1062,86,949,113,976,1.67032000612192,2.19472279874159,0.119072708113804
"United States","South Carolina","SC",2020-10-18,2020-10-24,7,2020,"43",5148714,1147,156,950,197,991,3.02988280180255,3.82619815355834,0.207368421052632
"United States","South Carolina","SC",2020-10-25,2020-10-31,7,2020,"44",5148714,1225,139,962,263,1086,2.69970326570868,5.10807164662865,0.273388773388773
"United States","South Carolina","SC",2020-11-01,2020-11-07,7,2020,"45",5148714,1185,83,966,219,1102,1.61205302916418,4.25348931791511,0.226708074534161
"United States","South Carolina","SC",2020-11-08,2020-11-14,7,2020,"46",5148714,1138,95,980,158,1043,1.84512093699514,3.06872745310771,0.161224489795918
"United States","South Carolina","SC",2020-11-15,2020-11-21,7,2020,"47",5148714,1192,90,985,207,1102,1.74800930873224,4.02042141008415,0.210152284263959
"United States","South Carolina","SC",2020-11-22,2020-11-28,7,2020,"48",5148714,1214,153,991,223,1061,2.97161582484481,4.33117862052544,0.225025227043391
"United States","South Carolina","SC",2020-11-29,2020-12-05,7,2020,"49",5148714,1287,164,995,292,1123,3.18526140702319,5.67131909055349,0.293467336683417
"United States","South Carolina","SC",2020-12-06,2020-12-12,7,2020,"50",5148714,1281,168,1011,270,1113,3.26295070963351,5.24402792619672,0.267062314540059
"United States","South Carolina","SC",2020-12-13,2020-12-19,7,2020,"51",5148714,1367,210,1027,340,1157,4.07868838704189,6.60359072187735,0.331061343719572
"United States","South Carolina","SC",2020-12-20,2020-12-26,7,2020,"52",5148714,1420,229,1042,378,1191,4.44771257444092,7.3416390966754,0.362763915547025
"United States","South Carolina","SC",2020-12-27,2021-01-02,7,2020,"53",5148714,1511,260,1048,463,1251,5.04980466967091,8.99253677714474,0.441793893129771
"United States","South Carolina","SC",2021-01-03,2021-01-09,7,2021,"1",5148714,1587,374,1073,514,1213,7.26394979406508,9.98307538542634,0.479030754892824
"United States","South Carolina","SC",2021-01-10,2021-01-16,7,2021,"2",5148714,1641,350,1081,560,1291,6.79781397840315,10.876502365445,0.518038852913969
"United States","South Carolina","SC",2021-01-17,2021-01-23,7,2021,"3",5148714,1699,371,1084,615,1328,7.20568281710734,11.944730276337,0.567343173431734
"United States","South Carolina","SC",2021-01-24,2021-01-30,7,2021,"4",5148714,1582,535,1085,497,1047,10.3909442241305,9.65289584933247,0.458064516129032
"United States","South Carolina","SC",2021-01-31,2021-02-06,7,2021,"5",5148714,1506,597,1076,430,909,11.5951284145905,8.35160003060959,0.399628252788104
"United States","South Carolina","SC",2021-02-07,2021-02-13,7,2021,"6",5148714,1373,302,1040,333,1071,5.86554234707929,6.46763444230928,0.320192307692308
"United States","South Carolina","SC",2021-02-14,2021-02-20,7,2021,"7",5148714,1255,344,1028,227,911,6.68128002448767,4.40886792313576,0.220817120622568
"United States","South Carolina","SC",2021-02-21,2021-02-27,7,2021,"8",5148714,1242,241,1016,226,1001,4.68078048227188,4.38944559748318,0.22244094488189
"United States","South Carolina","SC",2021-02-28,2021-03-06,7,2021,"9",5148714,1198,221,1014,184,977,4.29233396922028,3.5737079200748,0.181459566074951
"United States","South Carolina","SC",2021-03-07,2021-03-13,7,2021,"10",5148714,1169,152,1000,169,1017,2.95219349919223,3.28237303528609,0.169
"United States","South Carolina","SC",2021-03-14,2021-03-20,7,2021,"11",5148714,1053,108,1007,46,945,2.09761117047869,0.8934269800187,0.0456802383316783
"United States","South Carolina","SC",2021-03-21,2021-03-27,7,2021,"12",5148714,1107,129,1002,105,978,2.50548000918288,2.03934419352095,0.104790419161677
"United States","South Carolina","SC",2021-03-28,2021-04-03,7,2021,"13",5148714,998,92,990,8,906,1.7868539600374,0.155378605220643,0.00808080808080813
"United States","South Carolina","SC",2021-04-04,2021-04-10,7,2021,"14",5148714,1129,73,972,157,1056,1.41782977263837,3.04930512745513,0.161522633744856
"United States","South Carolina","SC",2021-04-11,2021-04-17,7,2021,"15",5148714,1094,48,973,121,1046,0.932271631323861,2.35010140396223,0.124357656731757
"United States","South Carolina","SC",2021-04-18,2021-04-24,7,2021,"16",5148714,1061,93,960,101,968,1.80627628568998,1.96165489091062,0.105208333333333
"United States","South Carolina","SC",2021-04-25,2021-05-01,7,2021,"17",5148714,1147,92,960,187,1055,1.7868539600374,3.63197489703254,0.194791666666667
"United States","South Carolina","SC",2021-05-02,2021-05-08,7,2021,"18",5148714,1066,80,957,109,986,1.55378605220643,2.11703349613127,0.113897596656217
"United States","South Carolina","SC",2021-05-09,2021-05-15,7,2021,"19",5148714,1080,52,949,131,1028,1.00996093393418,2.54432466048804,0.138040042149631
"United States","South Carolina","SC",2021-05-16,2021-05-22,7,2021,"20",5148714,1011,36,947,64,975,0.699203723492896,1.24302884176515,0.0675818373812038
"United States","South Carolina","SC",2021-05-23,2021-05-29,7,2021,"21",5148714,1008,54,949,59,954,1.04880558523934,1.14591721350225,0.0621707060063224
"United States","South Carolina","SC",2021-05-30,2021-06-05,7,2021,"22",5148714,1021,24,941,80,997,0.46613581566193,1.55378605220643,0.0850159404888418
"United States","South Carolina","SC",2021-06-06,2021-06-12,7,2021,"23",5148714,1016,24,929,87,992,0.46613581566193,1.6897423317745,0.093649085037675
"United States","South Carolina","SC",2021-06-13,2021-06-19,7,2021,"24",5148714,1054,16,930,124,1038,0.310757210441287,2.40836838091997,0.133333333333333
"United States","South Carolina","SC",2021-06-20,2021-06-26,7,2021,"25",5148714,996,27,922,74,969,0.524402792619672,1.43725209829095,0.0802603036876355
"United States","South Carolina","SC",2021-06-27,2021-07-03,7,2021,"26",5148714,946,11,918,28,935,0.213645582178385,0.543825118272252,0.0305010893246187
"United States","South Carolina","SC",2021-07-04,2021-07-10,7,2021,"27",5148714,762,16,921,-159,746,0.310757210441287,-3.08814977876029,-0.172638436482085
"United States","South Dakota","SD",2019-12-29,2020-01-04,7,2020,"1",884659,170,0,166,4,170,0,0.452151620002736,0.0240963855421688
"United States","South Dakota","SD",2020-01-05,2020-01-11,7,2020,"2",884659,170,0,168,2,170,0,0.226075810001368,0.0119047619047619
"United States","South Dakota","SD",2020-01-12,2020-01-18,7,2020,"3",884659,168,0,170,-2,168,0,-0.226075810001368,-0.0117647058823529
"United States","South Dakota","SD",2020-01-19,2020-01-25,7,2020,"4",884659,151,0,169,-18,151,0,-2.03468229001231,-0.106508875739645
"United States","South Dakota","SD",2020-01-26,2020-02-01,7,2020,"5",884659,162,0,168,-6,162,0,-0.678227430004103,-0.0357142857142857
"United States","South Dakota","SD",2020-02-02,2020-02-08,7,2020,"6",884659,150,0,168,-18,150,0,-2.03468229001231,-0.107142857142857
"United States","South Dakota","SD",2020-02-09,2020-02-15,7,2020,"7",884659,178,0,167,11,178,0,1.24341695500752,0.0658682634730539
"United States","South Dakota","SD",2020-02-16,2020-02-22,7,2020,"8",884659,177,0,166,11,177,0,1.24341695500752,0.0662650602409638
"United States","South Dakota","SD",2020-02-23,2020-02-29,7,2020,"9",884659,163,0,164,-1,163,0,-0.113037905000684,-0.00609756097560976
"United States","South Dakota","SD",2020-03-01,2020-03-07,7,2020,"10",884659,194,0,163,31,194,0,3.5041750550212,0.190184049079755
"United States","South Dakota","SD",2020-03-08,2020-03-14,7,2020,"11",884659,166,1,164,2,165,0.113037905000684,0.226075810001368,0.0121951219512195
"United States","South Dakota","SD",2020-03-15,2020-03-21,7,2020,"12",884659,162,0,160,2,162,0,0.226075810001368,0.0125
"United States","South Dakota","SD",2020-03-22,2020-03-28,7,2020,"13",884659,149,0,159,-10,149,0,-1.13037905000684,-0.0628930817610063
"United States","South Dakota","SD",2020-03-29,2020-04-04,7,2020,"14",884659,170,1,160,10,169,0.113037905000684,1.13037905000684,0.0625
"United States","South Dakota","SD",2020-04-05,2020-04-11,7,2020,"15",884659,150,3,159,-9,147,0.339113715002052,-1.01734114500615,-0.0566037735849056
"United States","South Dakota","SD",2020-04-12,2020-04-18,7,2020,"16",884659,154,2,156,-2,152,0.226075810001368,-0.226075810001368,-0.0128205128205128
"United States","South Dakota","SD",2020-04-19,2020-04-25,7,2020,"17",884659,176,3,153,23,173,0.339113715002052,2.59987181501573,0.150326797385621
"United States","South Dakota","SD",2020-04-26,2020-05-02,7,2020,"18",884659,159,11,149,10,148,1.24341695500752,1.13037905000684,0.0671140939597314
"United States","South Dakota","SD",2020-05-03,2020-05-09,7,2020,"19",884659,181,13,148,33,168,1.46949276500889,3.73025086502257,0.222972972972973
"United States","South Dakota","SD",2020-05-10,2020-05-16,7,2020,"20",884659,147,10,147,0,137,1.13037905000684,0,0
"United States","South Dakota","SD",2020-05-17,2020-05-23,7,2020,"21",884659,162,6,147,15,156,0.678227430004103,1.69556857501026,0.102040816326531
"United States","South Dakota","SD",2020-05-24,2020-05-30,7,2020,"22",884659,157,10,151,6,147,1.13037905000684,0.678227430004103,0.0397350993377483
"United States","South Dakota","SD",2020-05-31,2020-06-06,7,2020,"23",884659,147,5,146,1,142,0.565189525003419,0.113037905000684,0.00684931506849318
"United States","South Dakota","SD",2020-06-07,2020-06-13,7,2020,"24",884659,159,10,146,13,149,1.13037905000684,1.46949276500889,0.0890410958904109
"United States","South Dakota","SD",2020-06-14,2020-06-20,7,2020,"25",884659,176,6,148,28,170,0.678227430004103,3.16506134001915,0.189189189189189
"United States","South Dakota","SD",2020-06-21,2020-06-27,7,2020,"26",884659,163,10,145,18,153,1.13037905000684,2.03468229001231,0.124137931034483
"United States","South Dakota","SD",2020-06-28,2020-07-04,7,2020,"27",884659,160,6,143,17,154,0.678227430004103,1.92164438501163,0.118881118881119
"United States","South Dakota","SD",2020-07-05,2020-07-11,7,2020,"28",884659,172,12,144,28,160,1.35645486000821,3.16506134001915,0.194444444444444
"United States","South Dakota","SD",2020-07-12,2020-07-18,7,2020,"29",884659,158,7,145,13,151,0.791265335004787,1.46949276500889,0.0896551724137931
"United States","South Dakota","SD",2020-07-19,2020-07-25,7,2020,"30",884659,173,6,143,30,167,0.678227430004103,3.39113715002052,0.20979020979021
"United States","South Dakota","SD",2020-07-26,2020-08-01,7,2020,"31",884659,151,12,144,7,139,1.35645486000821,0.791265335004787,0.0486111111111112
"United States","South Dakota","SD",2020-08-02,2020-08-08,7,2020,"32",884659,187,12,139,48,175,1.35645486000821,5.42581944003283,0.345323741007194
"United States","South Dakota","SD",2020-08-09,2020-08-15,7,2020,"33",884659,162,6,140,22,156,0.678227430004103,2.48683391001505,0.157142857142857
"United States","South Dakota","SD",2020-08-16,2020-08-22,7,2020,"34",884659,169,7,140,29,162,0.791265335004787,3.27809924501983,0.207142857142857
"United States","South Dakota","SD",2020-08-23,2020-08-29,7,2020,"35",884659,189,8,140,49,181,0.904303240005471,5.53885734503351,0.35
"United States","South Dakota","SD",2020-08-30,2020-09-05,7,2020,"36",884659,209,6,137,72,203,0.678227430004103,8.13872916004924,0.525547445255474
"United States","South Dakota","SD",2020-09-06,2020-09-12,7,2020,"37",884659,182,10,140,42,172,1.13037905000684,4.74759201002872,0.3
"United States","South Dakota","SD",2020-09-13,2020-09-19,7,2020,"38",884659,181,17,139,42,164,1.92164438501163,4.74759201002872,0.302158273381295
"United States","South Dakota","SD",2020-09-20,2020-09-26,7,2020,"39",884659,191,18,144,47,173,2.03468229001231,5.31278153503214,0.326388888888889
"United States","South Dakota","SD",2020-09-27,2020-10-03,7,2020,"40",884659,206,30,151,55,176,3.39113715002052,6.21708477503761,0.364238410596027
"United States","South Dakota","SD",2020-10-04,2020-10-10,7,2020,"41",884659,215,38,153,62,177,4.29544039002599,7.0083501100424,0.405228758169935
"United States","South Dakota","SD",2020-10-11,2020-10-17,7,2020,"42",884659,201,29,158,43,172,3.27809924501983,4.86062991502941,0.272151898734177
"United States","South Dakota","SD",2020-10-18,2020-10-24,7,2020,"43",884659,243,51,159,84,192,5.76493315503488,9.49518402005745,0.528301886792453
"United States","South Dakota","SD",2020-10-25,2020-10-31,7,2020,"44",884659,243,59,157,86,184,6.66923639504035,9.72125983005881,0.547770700636943
"United States","South Dakota","SD",2020-11-01,2020-11-07,7,2020,"45",884659,356,98,152,204,258,11.077714690067,23.0597326201395,1.34210526315789
"United States","South Dakota","SD",2020-11-08,2020-11-14,7,2020,"46",884659,343,98,156,187,245,11.077714690067,21.1380882351279,1.19871794871795
"United States","South Dakota","SD",2020-11-15,2020-11-21,7,2020,"47",884659,335,120,153,182,215,13.5645486000821,20.5728987101245,1.18954248366013
"United States","South Dakota","SD",2020-11-22,2020-11-28,7,2020,"48",884659,335,201,154,181,134,22.7206189051375,20.4598608051238,1.17532467532468
"United States","South Dakota","SD",2020-11-29,2020-12-05,7,2020,"49",884659,305,148,159,146,157,16.7296099401012,16.5035341300998,0.918238993710692
"United States","South Dakota","SD",2020-12-06,2020-12-12,7,2020,"50",884659,283,153,159,124,130,17.2947994651046,14.0167002200848,0.779874213836478
"United States","South Dakota","SD",2020-12-13,2020-12-19,7,2020,"51",884659,236,107,158,78,129,12.0950558350732,8.81695659005334,0.493670886075949
"United States","South Dakota","SD",2020-12-20,2020-12-26,7,2020,"52",884659,206,31,160,46,175,3.5041750550212,5.19974363003146,0.2875
"United States","South Dakota","SD",2020-12-27,2021-01-02,7,2020,"53",884659,211,120,162,49,91,13.5645486000821,5.53885734503351,0.302469135802469
"United States","South Dakota","SD",2021-01-03,2021-01-09,7,2021,"1",884659,219,69,165,54,150,7.79961544504719,6.10404687003693,0.327272727272727
"United States","South Dakota","SD",2021-01-10,2021-01-16,7,2021,"2",884659,188,63,168,20,125,7.12138801504308,2.26075810001368,0.119047619047619
"United States","South Dakota","SD",2021-01-17,2021-01-23,7,2021,"3",884659,189,63,170,19,126,7.12138801504308,2.14772019501299,0.111764705882353
"United States","South Dakota","SD",2021-01-24,2021-01-30,7,2021,"4",884659,206,79,173,33,127,8.92999449505403,3.73025086502257,0.190751445086705
"United States","South Dakota","SD",2021-01-31,2021-02-06,7,2021,"5",884659,192,29,173,19,163,3.27809924501983,2.14772019501299,0.109826589595376
"United States","South Dakota","SD",2021-02-07,2021-02-13,7,2021,"6",884659,183,34,173,10,149,3.84328877002325,1.13037905000684,0.0578034682080926
"United States","South Dakota","SD",2021-02-14,2021-02-20,7,2021,"7",884659,170,21,171,-1,149,2.37379600501436,-0.113037905000684,-0.00584795321637432
"United States","South Dakota","SD",2021-02-21,2021-02-27,7,2021,"8",884659,183,29,176,7,154,3.27809924501983,0.791265335004787,0.0397727272727273
"United States","South Dakota","SD",2021-02-28,2021-03-06,7,2021,"9",884659,171,8,176,-5,163,0.904303240005471,-0.565189525003419,-0.0284090909090909
"United States","South Dakota","SD",2021-03-07,2021-03-13,7,2021,"10",884659,188,12,175,13,176,1.35645486000821,1.46949276500889,0.0742857142857143
"United States","South Dakota","SD",2021-03-14,2021-03-20,7,2021,"11",884659,157,11,177,-20,146,1.24341695500752,-2.26075810001368,-0.112994350282486
"United States","South Dakota","SD",2021-03-21,2021-03-27,7,2021,"12",884659,168,14,173,-5,154,1.58253067000957,-0.565189525003419,-0.0289017341040463
"United States","South Dakota","SD",2021-03-28,2021-04-03,7,2021,"13",884659,155,14,173,-18,141,1.58253067000957,-2.03468229001231,-0.104046242774566
"United States","South Dakota","SD",2021-04-04,2021-04-10,7,2021,"14",884659,144,-1,169,-25,145,-0.113037905000684,-2.8259476250171,-0.14792899408284
"United States","South Dakota","SD",2021-04-11,2021-04-17,7,2021,"15",884659,176,7,172,4,169,0.791265335004787,0.452151620002736,0.0232558139534884
"United States","South Dakota","SD",2021-04-18,2021-04-24,7,2021,"16",884659,170,0,172,-2,170,0,-0.226075810001368,-0.0116279069767442
"United States","South Dakota","SD",2021-04-25,2021-05-01,7,2021,"17",884659,158,14,170,-12,144,1.58253067000957,-1.35645486000821,-0.0705882352941176
"United States","South Dakota","SD",2021-05-02,2021-05-08,7,2021,"18",884659,175,12,166,9,163,1.35645486000821,1.01734114500615,0.0542168674698795
"United States","South Dakota","SD",2021-05-09,2021-05-15,7,2021,"19",884659,163,12,166,-3,151,1.35645486000821,-0.339113715002052,-0.0180722891566265
"United States","South Dakota","SD",2021-05-16,2021-05-22,7,2021,"20",884659,152,10,162,-10,142,1.13037905000684,-1.13037905000684,-0.0617283950617284
"United States","South Dakota","SD",2021-05-23,2021-05-29,7,2021,"21",884659,138,9,164,-26,129,1.01734114500615,-2.93898553001778,-0.158536585365854
"United States","South Dakota","SD",2021-05-30,2021-06-05,7,2021,"22",884659,150,12,167,-17,138,1.35645486000821,-1.92164438501163,-0.101796407185629
"United States","South Dakota","SD",2021-06-06,2021-06-12,7,2021,"23",884659,153,4,166,-13,149,0.452151620002736,-1.46949276500889,-0.0783132530120482
"United States","South Dakota","SD",2021-06-13,2021-06-19,7,2021,"24",884659,137,1,166,-29,136,0.113037905000684,-3.27809924501983,-0.174698795180723
"United States","South Dakota","SD",2021-06-20,2021-06-26,7,2021,"25",884659,132,3,168,-36,129,0.339113715002052,-4.06936458002462,-0.214285714285714
"United States","South Dakota","SD",2021-06-27,2021-07-03,7,2021,"26",884659,134,8,162,-28,126,0.904303240005471,-3.16506134001915,-0.172839506172839
"United States","South Dakota","SD",2021-07-04,2021-07-10,7,2021,"27",884659,123,1,161,-38,122,0.113037905000684,-4.29544039002599,-0.236024844720497
"United States","Tennessee","TN",2019-12-29,2020-01-04,7,2020,"1",6833174,1614,0,1644,-30,1614,0,-0.43903462724643,-0.0182481751824818
"United States","Tennessee","TN",2020-01-05,2020-01-11,7,2020,"2",6833174,1687,0,1637,50,1687,0,0.731724378744051,0.030543677458766
"United States","Tennessee","TN",2020-01-12,2020-01-18,7,2020,"3",6833174,1597,0,1645,-48,1597,0,-0.702455403594289,-0.0291793313069909
"United States","Tennessee","TN",2020-01-19,2020-01-25,7,2020,"4",6833174,1532,0,1633,-101,1532,0,-1.47808324506298,-0.0618493570116351
"United States","Tennessee","TN",2020-01-26,2020-02-01,7,2020,"5",6833174,1591,0,1629,-38,1591,0,-0.556110527845479,-0.0233271945979129
"United States","Tennessee","TN",2020-02-02,2020-02-08,7,2020,"6",6833174,1612,0,1603,9,1612,0,0.131710388173929,0.00561447286338113
"United States","Tennessee","TN",2020-02-09,2020-02-15,7,2020,"7",6833174,1454,0,1582,-128,1454,0,-1.87321440958477,-0.0809102402022756
"United States","Tennessee","TN",2020-02-16,2020-02-22,7,2020,"8",6833174,1516,0,1563,-47,1516,0,-0.687820916019408,-0.0300703774792066
"United States","Tennessee","TN",2020-02-23,2020-02-29,7,2020,"9",6833174,1504,0,1562,-58,1504,0,-0.848800279343099,-0.0371318822023048
"United States","Tennessee","TN",2020-03-01,2020-03-07,7,2020,"10",6833174,1611,0,1546,65,1611,0,0.951241692367266,0.0420439844760672
"United States","Tennessee","TN",2020-03-08,2020-03-14,7,2020,"11",6833174,1601,0,1539,62,1601,0,0.907338229642623,0.0402858999350229
"United States","Tennessee","TN",2020-03-15,2020-03-21,7,2020,"12",6833174,1526,1,1538,-12,1525,0.014634487574881,-0.175613850898572,-0.00780234070221064
"United States","Tennessee","TN",2020-03-22,2020-03-28,7,2020,"13",6833174,1528,5,1525,3,1523,0.0731724378744051,0.043903462724643,0.00196721311475412
"United States","Tennessee","TN",2020-03-29,2020-04-04,7,2020,"14",6833174,1593,37,1504,89,1556,0.541476040270597,1.30246939416441,0.0591755319148937
"United States","Tennessee","TN",2020-04-05,2020-04-11,7,2020,"15",6833174,1514,58,1510,4,1456,0.848800279343099,0.0585379502995241,0.00264900662251666
"United States","Tennessee","TN",2020-04-12,2020-04-18,7,2020,"16",6833174,1541,44,1495,46,1497,0.643917453294765,0.673186428444527,0.0307692307692307
"United States","Tennessee","TN",2020-04-19,2020-04-25,7,2020,"17",6833174,1483,33,1470,13,1450,0.482938089971073,0.190248338473453,0.00884353741496602
"United States","Tennessee","TN",2020-04-26,2020-05-02,7,2020,"18",6833174,1495,31,1447,48,1464,0.453669114821311,0.702455403594289,0.0331720801658604
"United States","Tennessee","TN",2020-05-03,2020-05-09,7,2020,"19",6833174,1492,33,1436,56,1459,0.482938089971073,0.819531304193337,0.0389972144846797
"United States","Tennessee","TN",2020-05-10,2020-05-16,7,2020,"20",6833174,1544,53,1413,131,1491,0.775627841468694,1.91711787230941,0.0927105449398442
"United States","Tennessee","TN",2020-05-17,2020-05-23,7,2020,"21",6833174,1557,30,1413,144,1527,0.43903462724643,2.10736621078287,0.101910828025478
"United States","Tennessee","TN",2020-05-24,2020-05-30,7,2020,"22",6833174,1467,39,1414,53,1428,0.57074501542036,0.775627841468694,0.0374823196605374
"United States","Tennessee","TN",2020-05-31,2020-06-06,7,2020,"23",6833174,1485,49,1410,75,1436,0.71708989116917,1.09758656811608,0.053191489361702
"United States","Tennessee","TN",2020-06-07,2020-06-13,7,2020,"24",6833174,1500,52,1405,95,1448,0.760993353893813,1.3902763196137,0.0676156583629892
"United States","Tennessee","TN",2020-06-14,2020-06-20,7,2020,"25",6833174,1570,51,1414,156,1519,0.746358866318932,2.28298006168144,0.11032531824611
"United States","Tennessee","TN",2020-06-21,2020-06-27,7,2020,"26",6833174,1562,61,1421,141,1501,0.892703742067742,2.06346274805822,0.0992258972554538
"United States","Tennessee","TN",2020-06-28,2020-07-04,7,2020,"27",6833174,1533,52,1408,125,1481,0.760993353893813,1.82931094686013,0.0887784090909092
"United States","Tennessee","TN",2020-07-05,2020-07-11,7,2020,"28",6833174,1634,99,1412,222,1535,1.44881426991322,3.24885624162359,0.157223796033994
"United States","Tennessee","TN",2020-07-12,2020-07-18,7,2020,"29",6833174,1650,100,1425,225,1550,1.4634487574881,3.29275970434823,0.157894736842105
"United States","Tennessee","TN",2020-07-19,2020-07-25,7,2020,"30",6833174,1710,136,1412,298,1574,1.99029031018382,4.36107729731454,0.211048158640227
"United States","Tennessee","TN",2020-07-26,2020-08-01,7,2020,"31",6833174,1713,103,1398,315,1610,1.50735222021274,4.60986358608752,0.225321888412017
"United States","Tennessee","TN",2020-08-02,2020-08-08,7,2020,"32",6833174,1707,148,1388,319,1559,2.16590416108239,4.66840153638704,0.229827089337176
"United States","Tennessee","TN",2020-08-09,2020-08-15,7,2020,"33",6833174,1678,130,1379,299,1548,1.90248338473453,4.37571178488942,0.216823785351704
"United States","Tennessee","TN",2020-08-16,2020-08-22,7,2020,"34",6833174,1687,218,1364,323,1469,3.19031829132406,4.72693948668657,0.236803519061584
"United States","Tennessee","TN",2020-08-23,2020-08-29,7,2020,"35",6833174,1709,162,1365,344,1547,2.37078698713072,5.03426372575907,0.252014652014652
"United States","Tennessee","TN",2020-08-30,2020-09-05,7,2020,"36",6833174,1624,137,1378,246,1487,2.0049247977587,3.60008394342073,0.178519593613933
"United States","Tennessee","TN",2020-09-06,2020-09-12,7,2020,"37",6833174,1727,202,1375,352,1525,2.95616649012596,5.15133962635812,0.256
"United States","Tennessee","TN",2020-09-13,2020-09-19,7,2020,"38",6833174,1620,152,1380,240,1468,2.22444211138191,3.51227701797144,0.173913043478261
"United States","Tennessee","TN",2020-09-20,2020-09-26,7,2020,"39",6833174,1743,158,1393,350,1585,2.3122490368312,5.12207065120836,0.251256281407035
"United States","Tennessee","TN",2020-09-27,2020-10-03,7,2020,"40",6833174,1732,186,1383,349,1546,2.72201468892787,5.10743616363347,0.25234996384671
"United States","Tennessee","TN",2020-10-04,2020-10-10,7,2020,"41",6833174,1769,198,1390,379,1571,2.89762853982644,5.5464707908799,0.272661870503597
"United States","Tennessee","TN",2020-10-11,2020-10-17,7,2020,"42",6833174,1784,145,1401,383,1639,2.12200069835775,5.60500874117943,0.273376159885796
"United States","Tennessee","TN",2020-10-18,2020-10-24,7,2020,"43",6833174,1788,197,1407,381,1591,2.88299405225156,5.57573976602967,0.270788912579957
"United States","Tennessee","TN",2020-10-25,2020-10-31,7,2020,"44",6833174,1841,251,1410,431,1590,3.67325638129513,6.30746414477372,0.305673758865248
"United States","Tennessee","TN",2020-11-01,2020-11-07,7,2020,"45",6833174,1815,236,1439,376,1579,3.45373906767192,5.50256732815526,0.26129256428075
"United States","Tennessee","TN",2020-11-08,2020-11-14,7,2020,"46",6833174,1935,290,1447,488,1645,4.24400139671549,7.14162993654193,0.337249481686247
"United States","Tennessee","TN",2020-11-15,2020-11-21,7,2020,"47",6833174,2001,324,1466,535,1677,4.74157397426145,7.82945085256134,0.36493860845839
"United States","Tennessee","TN",2020-11-22,2020-11-28,7,2020,"48",6833174,1919,333,1496,423,1586,4.87328436243538,6.19038824417467,0.282754010695187
"United States","Tennessee","TN",2020-11-29,2020-12-05,7,2020,"49",6833174,2200,365,1520,680,1835,5.34158796483157,9.95145155091909,0.447368421052632
"United States","Tennessee","TN",2020-12-06,2020-12-12,7,2020,"50",6833174,2188,499,1528,660,1689,7.30260929986563,9.65876179942147,0.431937172774869
"United States","Tennessee","TN",2020-12-13,2020-12-19,7,2020,"51",6833174,2174,562,1554,620,1612,8.22458201708313,9.07338229642623,0.398970398970399
"United States","Tennessee","TN",2020-12-20,2020-12-26,7,2020,"52",6833174,2361,481,1575,786,1880,7.03918852351777,11.5027072338565,0.499047619047619
"United States","Tennessee","TN",2020-12-27,2021-01-02,7,2020,"53",6833174,2365,529,1577,788,1836,7.74164392711206,11.5319762090062,0.499682942295498
"United States","Tennessee","TN",2021-01-03,2021-01-09,7,2021,"1",6833174,2425,734,1597,828,1691,10.7417138799627,12.1173557120015,0.518472135253601
"United States","Tennessee","TN",2021-01-10,2021-01-16,7,2021,"2",6833174,2305,651,1606,699,1654,9.52705141124754,10.2295068148418,0.435242839352428
"United States","Tennessee","TN",2021-01-17,2021-01-23,7,2021,"3",6833174,2283,463,1602,681,1820,6.77576774716991,9.96608603849397,0.425093632958802
"United States","Tennessee","TN",2021-01-24,2021-01-30,7,2021,"4",6833174,2088,756,1609,479,1332,11.06367260661,7.00991954836801,0.297700435052828
"United States","Tennessee","TN",2021-01-31,2021-02-06,7,2021,"5",6833174,1955,889,1610,345,1066,13.0100594540692,5.04889821333395,0.214285714285714
"United States","Tennessee","TN",2021-02-07,2021-02-13,7,2021,"6",6833174,1777,468,1585,192,1309,6.84894018504431,2.80982161437715,0.121135646687697
"United States","Tennessee","TN",2021-02-14,2021-02-20,7,2021,"7",6833174,1797,199,1557,240,1598,2.91226302740132,3.51227701797144,0.154142581888247
"United States","Tennessee","TN",2021-02-21,2021-02-27,7,2021,"8",6833174,1756,274,1537,219,1482,4.0098495955174,3.20495277889894,0.142485361093038
"United States","Tennessee","TN",2021-02-28,2021-03-06,7,2021,"9",6833174,1666,146,1535,131,1520,2.13663518593263,1.91711787230941,0.085342019543974
"United States","Tennessee","TN",2021-03-07,2021-03-13,7,2021,"10",6833174,1602,96,1515,87,1506,1.40491080718858,1.27320041901465,0.0574257425742575
"United States","Tennessee","TN",2021-03-14,2021-03-20,7,2021,"11",6833174,1579,73,1514,65,1506,1.06831759296631,0.951241692367266,0.0429326287978864
"United States","Tennessee","TN",2021-03-21,2021-03-27,7,2021,"12",6833174,1657,102,1514,143,1555,1.49271773263786,2.09273172320799,0.09445178335535
"United States","Tennessee","TN",2021-03-28,2021-04-03,7,2021,"13",6833174,1572,94,1517,55,1478,1.37564183203882,0.804896816618456,0.0362557679630851
"United States","Tennessee","TN",2021-04-04,2021-04-10,7,2021,"14",6833174,1692,86,1510,182,1606,1.25856593143977,2.66347673862834,0.120529801324503
"United States","Tennessee","TN",2021-04-11,2021-04-17,7,2021,"15",6833174,1620,65,1510,110,1555,0.951241692367266,1.60979363323691,0.0728476821192052
"United States","Tennessee","TN",2021-04-18,2021-04-24,7,2021,"16",6833174,1675,80,1486,189,1595,1.17075900599048,2.76591815165251,0.127187079407806
"United States","Tennessee","TN",2021-04-25,2021-05-01,7,2021,"17",6833174,1644,58,1478,166,1586,0.848800279343099,2.42932493743025,0.112313937753721
"United States","Tennessee","TN",2021-05-02,2021-05-08,7,2021,"18",6833174,1644,53,1469,175,1591,0.775627841468694,2.56103532560418,0.119128658951668
"United States","Tennessee","TN",2021-05-09,2021-05-15,7,2021,"19",6833174,1632,55,1461,171,1577,0.804896816618456,2.50249737530465,0.117043121149897
"United States","Tennessee","TN",2021-05-16,2021-05-22,7,2021,"20",6833174,1557,68,1461,96,1489,0.995145155091909,1.40491080718858,0.0657084188911705
"United States","Tennessee","TN",2021-05-23,2021-05-29,7,2021,"21",6833174,1532,61,1450,82,1471,0.892703742067742,1.20002798114024,0.056551724137931
"United States","Tennessee","TN",2021-05-30,2021-06-05,7,2021,"22",6833174,1547,35,1435,112,1512,0.512207065120835,1.63906260838667,0.0780487804878049
"United States","Tennessee","TN",2021-06-06,2021-06-12,7,2021,"23",6833174,1653,22,1434,219,1631,0.321958726647382,3.20495277889894,0.152719665271966
"United States","Tennessee","TN",2021-06-13,2021-06-19,7,2021,"24",6833174,1545,18,1430,115,1527,0.263420776347858,1.68296607111132,0.0804195804195804
"United States","Tennessee","TN",2021-06-20,2021-06-26,7,2021,"25",6833174,1489,34,1419,70,1455,0.497572577545954,1.02441413024167,0.0493305144467935
"United States","Tennessee","TN",2021-06-27,2021-07-03,7,2021,"26",6833174,1365,21,1415,-50,1344,0.307324239072501,-0.731724378744051,-0.0353356890459364
"United States","Tennessee","TN",2021-07-04,2021-07-10,7,2021,"27",6833174,1092,25,1417,-325,1067,0.365862189372025,-4.75620846183633,-0.229357798165138
"United States","Texas","TX",2019-12-29,2020-01-04,7,2020,"1",28995881,4325,0,4520,-195,4325,0,-0.672509312615816,-0.043141592920354
"United States","Texas","TX",2020-01-05,2020-01-11,7,2020,"2",28995881,4564,0,4486,78,4564,0,0.269003725046326,0.0173874275523851
"United States","Texas","TX",2020-01-12,2020-01-18,7,2020,"3",28995881,4250,0,4484,-234,4250,0,-0.807011175138979,-0.052185548617306
"United States","Texas","TX",2020-01-19,2020-01-25,7,2020,"4",28995881,4128,0,4518,-390,4128,0,-1.34501862523163,-0.0863213811420983
"United States","Texas","TX",2020-01-26,2020-02-01,7,2020,"5",28995881,4174,0,4485,-311,4174,0,-1.07256613447958,-0.0693422519509476
"United States","Texas","TX",2020-02-02,2020-02-08,7,2020,"6",28995881,4322,0,4426,-104,4322,0,-0.358671633395102,-0.0234975146859466
"United States","Texas","TX",2020-02-09,2020-02-15,7,2020,"7",28995881,4343,0,4403,-60,4343,0,-0.206925942343328,-0.0136270724506019
"United States","Texas","TX",2020-02-16,2020-02-22,7,2020,"8",28995881,4221,0,4369,-148,4221,0,-0.510417324446876,-0.033875028610666
"United States","Texas","TX",2020-02-23,2020-02-29,7,2020,"9",28995881,4146,0,4306,-160,4146,0,-0.551802512915541,-0.0371574547143521
"United States","Texas","TX",2020-03-01,2020-03-07,7,2020,"10",28995881,4173,0,4255,-82,4173,0,-0.282798787869215,-0.0192714453584019
"United States","Texas","TX",2020-03-08,2020-03-14,7,2020,"11",28995881,4169,0,4211,-42,4169,0,-0.14484815964033,-0.00997387793873195
"United States","Texas","TX",2020-03-15,2020-03-21,7,2020,"12",28995881,4256,5,4154,102,4251,0.0172438285286107,0.351774101983658,0.0245546461242176
"United States","Texas","TX",2020-03-22,2020-03-28,7,2020,"13",28995881,4259,25,4098,161,4234,0.0862191426430533,0.555251278621264,0.0392874572962421
"United States","Texas","TX",2020-03-29,2020-04-04,7,2020,"14",28995881,4186,77,4045,141,4109,0.265554959340604,0.486275964506821,0.034857849196539
"United States","Texas","TX",2020-04-05,2020-04-11,7,2020,"15",28995881,4266,147,4002,264,4119,0.506968558741154,0.910474146310643,0.0659670164917541
"United States","Texas","TX",2020-04-12,2020-04-18,7,2020,"16",28995881,4294,199,3994,300,4095,0.686304375438704,1.03462971171664,0.0751126690035053
"United States","Texas","TX",2020-04-19,2020-04-25,7,2020,"17",28995881,4464,169,3947,517,4295,0.582841404267041,1.78301186985834,0.130985558652141
"United States","Texas","TX",2020-04-26,2020-05-02,7,2020,"18",28995881,4263,224,3933,330,4039,0.772523518081758,1.1380926828883,0.083905415713196
"United States","Texas","TX",2020-05-03,2020-05-09,7,2020,"19",28995881,4278,202,3917,361,4076,0.696650672555871,1.24500441976569,0.0921623691600715
"United States","Texas","TX",2020-05-10,2020-05-16,7,2020,"20",28995881,4280,256,3905,375,4024,0.882884020664866,1.2932871396458,0.0960307298335468
"United States","Texas","TX",2020-05-17,2020-05-23,7,2020,"21",28995881,4255,199,3872,383,4056,0.686304375438704,1.32087726529158,0.0989152892561984
"United States","Texas","TX",2020-05-24,2020-05-30,7,2020,"22",28995881,4156,142,3848,308,4014,0.489724730212543,1.06221983736242,0.0800415800415801
"United States","Texas","TX",2020-05-31,2020-06-06,7,2020,"23",28995881,4229,169,3852,377,4060,0.582841404267041,1.30018467105724,0.0978712357217031
"United States","Texas","TX",2020-06-07,2020-06-13,7,2020,"24",28995881,4396,141,3870,526,4255,0.486275964506821,1.81405076120984,0.135917312661499
"United States","Texas","TX",2020-06-14,2020-06-20,7,2020,"25",28995881,4509,207,3843,666,4302,0.713894501084482,2.29687796001094,0.173302107728337
"United States","Texas","TX",2020-06-21,2020-06-27,7,2020,"26",28995881,4566,204,3842,724,4362,0.703548203967315,2.49690637094282,0.18844351900052
"United States","Texas","TX",2020-06-28,2020-07-04,7,2020,"27",28995881,5036,242,3823,1213,4794,0.834601300784756,4.18335280104095,0.317290086319644
"United States","Texas","TX",2020-07-05,2020-07-11,7,2020,"28",28995881,5772,504,3806,1966,5268,1.73817791568396,6.78027337744972,0.516552811350499
"United States","Texas","TX",2020-07-12,2020-07-18,7,2020,"29",28995881,6264,753,3808,2456,5511,2.59692057640877,8.47016857325356,0.644957983193277
"United States","Texas","TX",2020-07-19,2020-07-25,7,2020,"30",28995881,6310,1020,3827,2483,5290,3.51774101983658,8.56328524730806,0.648811079174288
"United States","Texas","TX",2020-07-26,2020-08-01,7,2020,"31",28995881,5953,1950,3821,2132,4003,6.72509312615816,7.35276848459959,0.557969118031929
"United States","Texas","TX",2020-08-02,2020-08-08,7,2020,"32",28995881,5712,1506,3838,1874,4206,5.19384115281753,6.46298693252328,0.488275143303804
"United States","Texas","TX",2020-08-09,2020-08-15,7,2020,"33",28995881,5782,1498,3838,1944,4284,5.16625102717176,6.70440053192383,0.506513809275664
"United States","Texas","TX",2020-08-16,2020-08-22,7,2020,"34",28995881,5033,1423,3814,1219,3610,4.9075935992426,4.20404539527528,0.319611955951757
"United States","Texas","TX",2020-08-23,2020-08-29,7,2020,"35",28995881,5137,1154,3809,1328,3983,3.97987562440334,4.57996085719899,0.348647939091625
"United States","Texas","TX",2020-08-30,2020-09-05,7,2020,"36",28995881,4942,987,3804,1138,3955,3.40393175154775,3.92469537311179,0.299158780231335
"United States","Texas","TX",2020-09-06,2020-09-12,7,2020,"37",28995881,4654,735,3792,862,3919,2.53484279370577,2.97283603833248,0.227320675105485
"United States","Texas","TX",2020-09-13,2020-09-19,7,2020,"38",28995881,4601,705,3787,814,3896,2.4313798225341,2.80729528445782,0.214945867441246
"United States","Texas","TX",2020-09-20,2020-09-26,7,2020,"39",28995881,4544,634,3803,741,3910,2.18651745742783,2.5555353879401,0.1948461740731
"United States","Texas","TX",2020-09-27,2020-10-03,7,2020,"40",28995881,4589,507,3828,761,4082,1.74852421280112,2.62451070205454,0.198798328108673
"United States","Texas","TX",2020-10-04,2020-10-10,7,2020,"41",28995881,4720,534,3850,870,4186,1.84164088685562,3.00042616397826,0.225974025974026
"United States","Texas","TX",2020-10-11,2020-10-17,7,2020,"42",28995881,4535,457,3897,638,4078,1.57608592751501,2.20031252025072,0.163715678727226
"United States","Texas","TX",2020-10-18,2020-10-24,7,2020,"43",28995881,4813,472,3940,873,4341,1.62781741310085,3.01077246109542,0.221573604060914
"United States","Texas","TX",2020-10-25,2020-10-31,7,2020,"44",28995881,5165,566,3970,1195,4599,1.95200138943873,4.12127501833795,0.301007556675063
"United States","Texas","TX",2020-11-01,2020-11-07,7,2020,"45",28995881,5402,674,3998,1404,4728,2.32446808565672,4.84206705083388,0.351175587793897
"United States","Texas","TX",2020-11-08,2020-11-14,7,2020,"46",28995881,5444,767,4025,1419,4677,2.64520329628888,4.89379853641971,0.352546583850932
"United States","Texas","TX",2020-11-15,2020-11-21,7,2020,"47",28995881,5431,827,4050,1381,4604,2.8521292386322,4.76274543960227,0.340987654320988
"United States","Texas","TX",2020-11-22,2020-11-28,7,2020,"48",28995881,5595,1013,4055,1540,4582,3.49359965989652,5.31109918681209,0.379778051787916
"United States","Texas","TX",2020-11-29,2020-12-05,7,2020,"49",28995881,5636,1194,4093,1543,4442,4.11782625263223,5.32144548392925,0.37698509650623
"United States","Texas","TX",2020-12-06,2020-12-12,7,2020,"50",28995881,6057,1297,4136,1921,4760,4.47304912032161,6.62507892069222,0.464458413926499
"United States","Texas","TX",2020-12-13,2020-12-19,7,2020,"51",28995881,6185,861,4210,1975,5324,2.96938727262676,6.81131226880121,0.469121140142518
"United States","Texas","TX",2020-12-20,2020-12-26,7,2020,"52",28995881,6134,1775,4287,1847,4359,6.12155912765679,6.36987025846878,0.430837415442034
"United States","Texas","TX",2020-12-27,2021-01-02,7,2020,"53",28995881,6542,1431,4351,2191,5111,4.93518372488837,7.55624566123719,0.503562399448403
"United States","Texas","TX",2021-01-03,2021-01-09,7,2021,"1",28995881,6967,1825,4358,2609,5142,6.29399741294289,8.99782972622905,0.598669114272602
"United States","Texas","TX",2021-01-10,2021-01-16,7,2021,"2",28995881,7198,2140,4379,2819,5058,7.38035861024536,9.72207052443069,0.643754281799498
"United States","Texas","TX",2021-01-17,2021-01-23,7,2021,"3",28995881,6990,2282,4370,2620,4708,7.87008334045791,9.03576614899199,0.59954233409611
"United States","Texas","TX",2021-01-24,2021-01-30,7,2021,"4",28995881,6666,2204,4377,2289,4462,7.60107961541158,7.89422470039796,0.522960932145305
"United States","Texas","TX",2021-01-31,2021-02-06,7,2021,"5",28995881,6263,2156,4345,1918,4107,7.43553886153692,6.61473262357505,0.441426927502877
"United States","Texas","TX",2021-02-07,2021-02-13,7,2021,"6",28995881,5926,1902,4322,1604,4024,6.5595523722835,5.5318201919783,0.371124479407682
"United States","Texas","TX",2021-02-14,2021-02-20,7,2021,"7",28995881,6434,834,4316,2118,5600,2.87627059857226,7.30448576471948,0.490732159406858
"United States","Texas","TX",2021-02-21,2021-02-27,7,2021,"8",28995881,5678,1526,4295,1383,4152,5.26281646693198,4.76964297101371,0.322002328288708
"United States","Texas","TX",2021-02-28,2021-03-06,7,2021,"9",28995881,5207,1627,4237,970,3580,5.61114180320991,3.34530273455047,0.228935567618598
"United States","Texas","TX",2021-03-07,2021-03-13,7,2021,"10",28995881,4938,1104,4178,760,3834,3.80743733911724,2.62106193634882,0.181905217807564
"United States","Texas","TX",2021-03-14,2021-03-20,7,2021,"11",28995881,4618,881,4149,469,3737,3.0383625867412,1.61747111598368,0.113039286575078
"United States","Texas","TX",2021-03-21,2021-03-27,7,2021,"12",28995881,4569,740,4080,489,3829,2.55208662223438,1.68644643009812,0.119852941176471
"United States","Texas","TX",2021-03-28,2021-04-03,7,2021,"13",28995881,4429,629,4020,409,3800,2.16927362889922,1.41054517364035,0.101741293532338
"United States","Texas","TX",2021-04-04,2021-04-10,7,2021,"14",28995881,4577,460,3961,616,4117,1.58643222463218,2.12443967472483,0.155516283766726
"United States","Texas","TX",2021-04-11,2021-04-17,7,2021,"15",28995881,4300,388,3929,371,3912,1.33812109382019,1.27949207682291,0.0944260626113516
"United States","Texas","TX",2021-04-18,2021-04-24,7,2021,"16",28995881,4557,372,3926,631,4185,1.28294084252863,2.17617116031067,0.160723382577687
"United States","Texas","TX",2021-04-25,2021-05-01,7,2021,"17",28995881,4423,341,3910,513,4082,1.17602910565125,1.76921680703545,0.131202046035806
"United States","Texas","TX",2021-05-02,2021-05-08,7,2021,"18",28995881,4347,293,3896,451,4054,1.01048835177659,1.55539333328068,0.115759753593429
"United States","Texas","TX",2021-05-09,2021-05-15,7,2021,"19",28995881,4361,305,3871,490,4056,1.05187354024525,1.68989519580385,0.126582278481013
"United States","Texas","TX",2021-05-16,2021-05-22,7,2021,"20",28995881,4256,261,3869,387,3995,0.900127849193477,1.33467232811447,0.100025846471957
"United States","Texas","TX",2021-05-23,2021-05-29,7,2021,"21",28995881,4264,263,3862,402,4001,0.907025380604921,1.3864038137003,0.104091144484723
"United States","Texas","TX",2021-05-30,2021-06-05,7,2021,"22",28995881,4194,218,3869,325,3976,0.751830923847425,1.12084885435969,0.0840010338588784
"United States","Texas","TX",2021-06-06,2021-06-12,7,2021,"23",28995881,4263,223,3860,403,4040,0.769074752376036,1.38985257940602,0.10440414507772
"United States","Texas","TX",2021-06-13,2021-06-19,7,2021,"24",28995881,4284,173,3869,415,4111,0.596636467089929,1.43123776787469,0.107262858619798
"United States","Texas","TX",2021-06-20,2021-06-26,7,2021,"25",28995881,4226,171,3839,387,4055,0.589738935678485,1.33467232811447,0.100807501953634
"United States","Texas","TX",2021-06-27,2021-07-03,7,2021,"26",28995881,3423,150,3819,-396,3273,0.51731485585832,-1.36571121946596,-0.10369206598586
"United States","Texas","TX",2021-07-04,2021-07-10,7,2021,"27",28995881,2429,140,3813,-1384,2289,0.482827198801099,-4.77309173671943,-0.362968790978232
"United States","Utah","UT",2019-12-29,2020-01-04,7,2020,"1",3205958,392,0,389,3,392,0,0.0935757736065164,0.00771208226221076
"United States","Utah","UT",2020-01-05,2020-01-11,7,2020,"2",3205958,438,0,396,42,438,0,1.31006083049123,0.106060606060606
"United States","Utah","UT",2020-01-12,2020-01-18,7,2020,"3",3205958,409,0,394,15,409,0,0.467878868032582,0.0380710659898478
"United States","Utah","UT",2020-01-19,2020-01-25,7,2020,"4",3205958,390,0,392,-2,390,0,-0.0623838490710109,-0.00510204081632648
"United States","Utah","UT",2020-01-26,2020-02-01,7,2020,"5",3205958,364,0,388,-24,364,0,-0.748606188852131,-0.0618556701030928
"United States","Utah","UT",2020-02-02,2020-02-08,7,2020,"6",3205958,395,0,391,4,395,0,0.124767698142022,0.0102301790281329
"United States","Utah","UT",2020-02-09,2020-02-15,7,2020,"7",3205958,414,0,391,23,414,0,0.717414264316625,0.0588235294117647
"United States","Utah","UT",2020-02-16,2020-02-22,7,2020,"8",3205958,368,0,393,-25,368,0,-0.779798113387636,-0.0636132315521628
"United States","Utah","UT",2020-02-23,2020-02-29,7,2020,"9",3205958,417,0,393,24,417,0,0.748606188852131,0.0610687022900764
"United States","Utah","UT",2020-03-01,2020-03-07,7,2020,"10",3205958,427,0,390,37,427,0,1.1541012078137,0.094871794871795
"United States","Utah","UT",2020-03-08,2020-03-14,7,2020,"11",3205958,406,0,390,16,406,0,0.499070792568087,0.0410256410256411
"United States","Utah","UT",2020-03-15,2020-03-21,7,2020,"12",3205958,412,0,382,30,412,0,0.935757736065164,0.0785340314136125
"United States","Utah","UT",2020-03-22,2020-03-28,7,2020,"13",3205958,395,3,380,15,392,0.0935757736065164,0.467878868032582,0.0394736842105263
"United States","Utah","UT",2020-03-29,2020-04-04,7,2020,"14",3205958,408,5,378,30,403,0.155959622677527,0.935757736065164,0.0793650793650793
"United States","Utah","UT",2020-04-05,2020-04-11,7,2020,"15",3205958,382,10,384,-2,372,0.311919245355055,-0.0623838490710109,-0.00520833333333337
"United States","Utah","UT",2020-04-12,2020-04-18,7,2020,"16",3205958,388,7,378,10,381,0.218343471748538,0.311919245355055,0.0264550264550265
"United States","Utah","UT",2020-04-19,2020-04-25,7,2020,"17",3205958,410,16,376,34,394,0.499070792568087,1.06052543420719,0.0904255319148937
"United States","Utah","UT",2020-04-26,2020-05-02,7,2020,"18",3205958,381,8,375,6,373,0.249535396284044,0.187151547213033,0.016
"United States","Utah","UT",2020-05-03,2020-05-09,7,2020,"19",3205958,372,19,375,-3,353,0.592646566174604,-0.0935757736065164,-0.00800000000000001
"United States","Utah","UT",2020-05-10,2020-05-16,7,2020,"20",3205958,403,10,371,32,393,0.311919245355055,0.998141585136175,0.0862533692722371
"United States","Utah","UT",2020-05-17,2020-05-23,7,2020,"21",3205958,374,19,377,-3,355,0.592646566174604,-0.0935757736065164,-0.00795755968169765
"United States","Utah","UT",2020-05-24,2020-05-30,7,2020,"22",3205958,390,11,379,11,379,0.34311116989056,0.34311116989056,0.029023746701847
"United States","Utah","UT",2020-05-31,2020-06-06,7,2020,"23",3205958,410,13,381,29,397,0.405495018961571,0.904565811529658,0.0761154855643045
"United States","Utah","UT",2020-06-07,2020-06-13,7,2020,"24",3205958,388,18,377,11,370,0.561454641639098,0.34311116989056,0.0291777188328912
"United States","Utah","UT",2020-06-14,2020-06-20,7,2020,"25",3205958,402,16,380,22,386,0.499070792568087,0.68622233978112,0.0578947368421052
"United States","Utah","UT",2020-06-21,2020-06-27,7,2020,"26",3205958,388,12,374,14,376,0.374303094426065,0.436686943497076,0.0374331550802138
"United States","Utah","UT",2020-06-28,2020-07-04,7,2020,"27",3205958,438,14,375,63,424,0.436686943497076,1.96509124573684,0.168
"United States","Utah","UT",2020-07-05,2020-07-11,7,2020,"28",3205958,407,31,369,38,376,0.966949660600669,1.18529313234921,0.102981029810298
"United States","Utah","UT",2020-07-12,2020-07-18,7,2020,"29",3205958,435,31,370,65,404,0.966949660600669,2.02747509480785,0.175675675675676
"United States","Utah","UT",2020-07-19,2020-07-25,7,2020,"30",3205958,437,31,369,68,406,0.966949660600669,2.12105086841437,0.184281842818428
"United States","Utah","UT",2020-07-26,2020-08-01,7,2020,"31",3205958,435,36,373,62,399,1.1229092832782,1.93389932120134,0.166219839142091
"United States","Utah","UT",2020-08-02,2020-08-08,7,2020,"32",3205958,449,25,368,81,424,0.779798113387636,2.52654588737594,0.220108695652174
"United States","Utah","UT",2020-08-09,2020-08-15,7,2020,"33",3205958,450,28,370,80,422,0.873373886994153,2.49535396284044,0.216216216216216
"United States","Utah","UT",2020-08-16,2020-08-22,7,2020,"34",3205958,422,23,367,55,399,0.717414264316625,1.7155558494528,0.149863760217984
"United States","Utah","UT",2020-08-23,2020-08-29,7,2020,"35",3205958,377,21,366,11,356,0.655030415245615,0.34311116989056,0.0300546448087431
"United States","Utah","UT",2020-08-30,2020-09-05,7,2020,"36",3205958,367,13,366,1,354,0.405495018961571,0.0311919245355055,0.00273224043715836
"United States","Utah","UT",2020-09-06,2020-09-12,7,2020,"37",3205958,382,13,368,14,369,0.405495018961571,0.436686943497076,0.0380434782608696
"United States","Utah","UT",2020-09-13,2020-09-19,7,2020,"38",3205958,400,7,365,35,393,0.218343471748538,1.09171735874269,0.095890410958904
"United States","Utah","UT",2020-09-20,2020-09-26,7,2020,"39",3205958,440,8,374,66,432,0.249535396284044,2.05866701934336,0.176470588235294
"United States","Utah","UT",2020-09-27,2020-10-03,7,2020,"40",3205958,393,28,381,12,365,0.873373886994153,0.374303094426065,0.0314960629921259
"United States","Utah","UT",2020-10-04,2020-10-10,7,2020,"41",3205958,443,37,383,60,406,1.1541012078137,1.87151547213033,0.156657963446475
"United States","Utah","UT",2020-10-11,2020-10-17,7,2020,"42",3205958,424,28,381,43,396,0.873373886994153,1.34125275502673,0.112860892388452
"United States","Utah","UT",2020-10-18,2020-10-24,7,2020,"43",3205958,442,27,377,65,415,0.842181962458647,2.02747509480785,0.172413793103448
"United States","Utah","UT",2020-10-25,2020-10-31,7,2020,"44",3205958,460,36,373,87,424,1.1229092832782,2.71369743458897,0.233243967828418
"United States","Utah","UT",2020-11-01,2020-11-07,7,2020,"45",3205958,453,54,374,79,399,1.68436392491729,2.46416203830493,0.211229946524064
"United States","Utah","UT",2020-11-08,2020-11-14,7,2020,"46",3205958,482,53,377,105,429,1.65317200038179,3.27515207622807,0.278514588859416
"United States","Utah","UT",2020-11-15,2020-11-21,7,2020,"47",3205958,544,64,378,166,480,1.99628317027235,5.17785947289391,0.439153439153439
"United States","Utah","UT",2020-11-22,2020-11-28,7,2020,"48",3205958,487,88,379,108,399,2.74488935912448,3.36872784983459,0.284960422163588
"United States","Utah","UT",2020-11-29,2020-12-05,7,2020,"49",3205958,538,76,385,153,462,2.37058626469841,4.77236445393233,0.397402597402597
"United States","Utah","UT",2020-12-06,2020-12-12,7,2020,"50",3205958,552,101,384,168,451,3.15038437808605,5.24024332196492,0.4375
"United States","Utah","UT",2020-12-13,2020-12-19,7,2020,"51",3205958,545,109,392,153,436,3.39991977437009,4.77236445393233,0.39030612244898
"United States","Utah","UT",2020-12-20,2020-12-26,7,2020,"52",3205958,502,7,400,102,495,0.218343471748538,3.18157630262156,0.255
"United States","Utah","UT",2020-12-27,2021-01-02,7,2020,"53",3205958,486,140,410,76,346,4.36686943497076,2.37058626469841,0.185365853658537
"United States","Utah","UT",2021-01-03,2021-01-09,7,2021,"1",3205958,533,97,414,119,436,3.02561667994403,3.71183901972515,0.28743961352657
"United States","Utah","UT",2021-01-10,2021-01-16,7,2021,"2",3205958,484,94,419,65,390,2.93204090633751,2.02747509480785,0.155131264916468
"United States","Utah","UT",2021-01-17,2021-01-23,7,2021,"3",3205958,496,97,415,81,399,3.02561667994403,2.52654588737594,0.195180722891566
"United States","Utah","UT",2021-01-24,2021-01-30,7,2021,"4",3205958,506,81,408,98,425,2.52654588737594,3.05680860447954,0.240196078431373
"United States","Utah","UT",2021-01-31,2021-02-06,7,2021,"5",3205958,470,71,403,67,399,2.21462664202089,2.08985894387887,0.166253101736973
"United States","Utah","UT",2021-02-07,2021-02-13,7,2021,"6",3205958,454,57,404,50,397,1.77793969852381,1.55959622677527,0.123762376237624
"United States","Utah","UT",2021-02-14,2021-02-20,7,2021,"7",3205958,430,50,407,23,380,1.55959622677527,0.717414264316625,0.0565110565110565
"United States","Utah","UT",2021-02-21,2021-02-27,7,2021,"8",3205958,382,65,411,-29,317,2.02747509480785,-0.904565811529658,-0.0705596107055961
"United States","Utah","UT",2021-02-28,2021-03-06,7,2021,"9",3205958,418,62,406,12,356,1.93389932120134,0.374303094426065,0.0295566502463054
"United States","Utah","UT",2021-03-07,2021-03-13,7,2021,"10",3205958,414,49,405,9,365,1.52840430223977,0.280727320819549,0.0222222222222221
"United States","Utah","UT",2021-03-14,2021-03-20,7,2021,"11",3205958,398,41,398,0,357,1.27886890595572,0,0
"United States","Utah","UT",2021-03-21,2021-03-27,7,2021,"12",3205958,394,60,389,5,334,1.87151547213033,0.155959622677527,0.012853470437018
"United States","Utah","UT",2021-03-28,2021-04-03,7,2021,"13",3205958,406,15,387,19,391,0.467878868032582,0.592646566174604,0.0490956072351421
"United States","Utah","UT",2021-04-04,2021-04-10,7,2021,"14",3205958,382,27,382,0,355,0.842181962458647,0,0
"United States","Utah","UT",2021-04-11,2021-04-17,7,2021,"15",3205958,373,4,382,-9,369,0.124767698142022,-0.280727320819549,-0.0235602094240838
"United States","Utah","UT",2021-04-18,2021-04-24,7,2021,"16",3205958,394,14,385,9,380,0.436686943497076,0.280727320819549,0.0233766233766233
"United States","Utah","UT",2021-04-25,2021-05-01,7,2021,"17",3205958,431,23,381,50,408,0.717414264316625,1.55959622677527,0.131233595800525
"United States","Utah","UT",2021-05-02,2021-05-08,7,2021,"18",3205958,389,20,378,11,369,0.623838490710109,0.34311116989056,0.0291005291005291
"United States","Utah","UT",2021-05-09,2021-05-15,7,2021,"19",3205958,384,35,380,4,349,1.09171735874269,0.124767698142022,0.0105263157894737
"United States","Utah","UT",2021-05-16,2021-05-22,7,2021,"20",3205958,409,32,374,35,377,0.998141585136175,1.09171735874269,0.0935828877005347
"United States","Utah","UT",2021-05-23,2021-05-29,7,2021,"21",3205958,441,11,375,66,430,0.34311116989056,2.05866701934336,0.176
"United States","Utah","UT",2021-05-30,2021-06-05,7,2021,"22",3205958,396,10,375,21,386,0.311919245355055,0.655030415245615,0.056
"United States","Utah","UT",2021-06-06,2021-06-12,7,2021,"23",3205958,392,8,370,22,384,0.249535396284044,0.68622233978112,0.0594594594594595
"United States","Utah","UT",2021-06-13,2021-06-19,7,2021,"24",3205958,418,7,368,50,411,0.218343471748538,1.55959622677527,0.135869565217391
"United States","Utah","UT",2021-06-20,2021-06-26,7,2021,"25",3205958,420,25,368,52,395,0.779798113387636,1.62198007584628,0.141304347826087
"United States","Utah","UT",2021-06-27,2021-07-03,7,2021,"26",3205958,414,27,365,49,387,0.842181962458647,1.52840430223977,0.134246575342466
"United States","Utah","UT",2021-07-04,2021-07-10,7,2021,"27",3205958,415,15,367,48,400,0.467878868032582,1.49721237770426,0.130790190735695
"United States","Vermont","VT",2019-12-29,2020-01-04,7,2020,"1",623989,92,0,120,-28,92,0,-4.48725858949437,-0.233333333333333
"United States","Vermont","VT",2020-01-05,2020-01-11,7,2020,"2",623989,111,0,124,-13,111,0,-2.0833700594081,-0.104838709677419
"United States","Vermont","VT",2020-01-12,2020-01-18,7,2020,"3",623989,134,0,120,14,134,0,2.24362929474718,0.116666666666667
"United States","Vermont","VT",2020-01-19,2020-01-25,7,2020,"4",623989,119,0,119,0,119,0,0,0
"United States","Vermont","VT",2020-01-26,2020-02-01,7,2020,"5",623989,96,0,115,-19,96,0,-3.04492547144261,-0.165217391304348
"United States","Vermont","VT",2020-02-02,2020-02-08,7,2020,"6",623989,121,0,113,8,121,0,1.28207388271268,0.0707964601769913
"United States","Vermont","VT",2020-02-09,2020-02-15,7,2020,"7",623989,135,0,110,25,135,0,4.00648088347711,0.227272727272727
"United States","Vermont","VT",2020-02-16,2020-02-22,7,2020,"8",623989,107,0,113,-6,107,0,-0.961555412034507,-0.0530973451327433
"United States","Vermont","VT",2020-02-23,2020-02-29,7,2020,"9",623989,137,0,113,24,137,0,3.84622164813803,0.212389380530974
"United States","Vermont","VT",2020-03-01,2020-03-07,7,2020,"10",623989,115,0,116,-1,115,0,-0.160259235339084,-0.00862068965517238
"United States","Vermont","VT",2020-03-08,2020-03-14,7,2020,"11",623989,140,0,116,24,140,0,3.84622164813803,0.206896551724138
"United States","Vermont","VT",2020-03-15,2020-03-21,7,2020,"12",623989,157,2,115,42,155,0.320518470678169,6.73088788424155,0.365217391304348
"United States","Vermont","VT",2020-03-22,2020-03-28,7,2020,"13",623989,128,10,114,14,118,1.60259235339085,2.24362929474718,0.12280701754386
"United States","Vermont","VT",2020-03-29,2020-04-04,7,2020,"14",623989,130,4,117,13,126,0.641036941356338,2.0833700594081,0.111111111111111
"United States","Vermont","VT",2020-04-05,2020-04-11,7,2020,"15",623989,109,8,112,-3,101,1.28207388271268,-0.480777706017254,-0.0267857142857143
"United States","Vermont","VT",2020-04-12,2020-04-18,7,2020,"16",623989,129,12,112,17,117,1.92311082406901,2.72440700076444,0.151785714285714
"United States","Vermont","VT",2020-04-19,2020-04-25,7,2020,"17",623989,138,9,108,30,129,1.44233311805176,4.80777706017254,0.277777777777778
"United States","Vermont","VT",2020-04-26,2020-05-02,7,2020,"18",623989,127,5,106,21,122,0.801296176695423,3.36544394212077,0.19811320754717
"United States","Vermont","VT",2020-05-03,2020-05-09,7,2020,"19",623989,112,3,104,8,109,0.480777706017254,1.28207388271268,0.0769230769230769
"United States","Vermont","VT",2020-05-10,2020-05-16,7,2020,"20",623989,115,0,104,11,115,0,1.76285158872993,0.105769230769231
"United States","Vermont","VT",2020-05-17,2020-05-23,7,2020,"21",623989,103,1,103,0,102,0.160259235339084,0,0
"United States","Vermont","VT",2020-05-24,2020-05-30,7,2020,"22",623989,143,1,108,35,142,0.160259235339084,5.60907323686796,0.324074074074074
"United States","Vermont","VT",2020-05-31,2020-06-06,7,2020,"23",623989,116,0,110,6,116,0,0.961555412034507,0.0545454545454545
"United States","Vermont","VT",2020-06-07,2020-06-13,7,2020,"24",623989,103,0,110,-7,103,0,-1.12181464737359,-0.0636363636363636
"United States","Vermont","VT",2020-06-14,2020-06-20,7,2020,"25",623989,102,1,105,-3,101,0.160259235339084,-0.480777706017254,-0.0285714285714286
"United States","Vermont","VT",2020-06-21,2020-06-27,7,2020,"26",623989,124,0,108,16,124,0,2.56414776542535,0.148148148148148
"United States","Vermont","VT",2020-06-28,2020-07-04,7,2020,"27",623989,91,0,106,-15,91,0,-2.40388853008627,-0.141509433962264
"United States","Vermont","VT",2020-07-05,2020-07-11,7,2020,"28",623989,112,0,102,10,112,0,1.60259235339085,0.0980392156862746
"United States","Vermont","VT",2020-07-12,2020-07-18,7,2020,"29",623989,104,0,102,2,104,0,0.320518470678169,0.0196078431372548
"United States","Vermont","VT",2020-07-19,2020-07-25,7,2020,"30",623989,115,0,106,9,115,0,1.44233311805176,0.0849056603773586
"United States","Vermont","VT",2020-07-26,2020-08-01,7,2020,"31",623989,120,1,102,18,119,0.160259235339084,2.88466623610352,0.176470588235294
"United States","Vermont","VT",2020-08-02,2020-08-08,7,2020,"32",623989,102,1,100,2,101,0.160259235339084,0.320518470678169,0.02
"United States","Vermont","VT",2020-08-09,2020-08-15,7,2020,"33",623989,104,0,101,3,104,0,0.480777706017254,0.0297029702970297
"United States","Vermont","VT",2020-08-16,2020-08-22,7,2020,"34",623989,138,0,104,34,138,0,5.44881400152887,0.326923076923077
"United States","Vermont","VT",2020-08-23,2020-08-29,7,2020,"35",623989,121,0,103,18,121,0,2.88466623610352,0.174757281553398
"United States","Vermont","VT",2020-08-30,2020-09-05,7,2020,"36",623989,113,0,100,13,113,0,2.0833700594081,0.13
"United States","Vermont","VT",2020-09-06,2020-09-12,7,2020,"37",623989,113,0,101,12,113,0,1.92311082406901,0.118811881188119
"United States","Vermont","VT",2020-09-13,2020-09-19,7,2020,"38",623989,113,0,101,12,113,0,1.92311082406901,0.118811881188119
"United States","Vermont","VT",2020-09-20,2020-09-26,7,2020,"39",623989,133,0,101,32,133,0,5.1282955308507,0.316831683168317
"United States","Vermont","VT",2020-09-27,2020-10-03,7,2020,"40",623989,106,0,105,1,106,0,0.160259235339084,0.00952380952380949
"United States","Vermont","VT",2020-10-04,2020-10-10,7,2020,"41",623989,138,0,108,30,138,0,4.80777706017254,0.277777777777778
"United States","Vermont","VT",2020-10-11,2020-10-17,7,2020,"42",623989,100,0,108,-8,100,0,-1.28207388271268,-0.0740740740740741
"United States","Vermont","VT",2020-10-18,2020-10-24,7,2020,"43",623989,122,0,111,11,122,0,1.76285158872993,0.0990990990990992
"United States","Vermont","VT",2020-10-25,2020-10-31,7,2020,"44",623989,117,0,113,4,117,0,0.641036941356338,0.0353982300884956
"United States","Vermont","VT",2020-11-01,2020-11-07,7,2020,"45",623989,112,1,109,3,111,0.160259235339084,0.480777706017254,0.0275229357798166
"United States","Vermont","VT",2020-11-08,2020-11-14,7,2020,"46",623989,122,0,107,15,122,0,2.40388853008627,0.14018691588785
"United States","Vermont","VT",2020-11-15,2020-11-21,7,2020,"47",623989,106,3,111,-5,103,0.480777706017254,-0.801296176695423,-0.045045045045045
"United States","Vermont","VT",2020-11-22,2020-11-28,7,2020,"48",623989,145,5,109,36,140,0.801296176695423,5.76933247220704,0.330275229357798
"United States","Vermont","VT",2020-11-29,2020-12-05,7,2020,"49",623989,149,12,106,43,137,1.92311082406901,6.89114711958063,0.405660377358491
"United States","Vermont","VT",2020-12-06,2020-12-12,7,2020,"50",623989,132,16,109,23,116,2.56414776542535,3.68596241279894,0.211009174311927
"United States","Vermont","VT",2020-12-13,2020-12-19,7,2020,"51",623989,142,13,115,27,129,2.0833700594081,4.32699935415528,0.234782608695652
"United States","Vermont","VT",2020-12-20,2020-12-26,7,2020,"52",623989,150,13,116,34,137,2.0833700594081,5.44881400152887,0.293103448275862
"United States","Vermont","VT",2020-12-27,2021-01-02,7,2020,"53",623989,138,18,121,17,120,2.88466623610352,2.72440700076444,0.140495867768595
"United States","Vermont","VT",2021-01-03,2021-01-09,7,2021,"1",623989,108,17,121,-13,91,2.72440700076444,-2.0833700594081,-0.107438016528926
"United States","Vermont","VT",2021-01-10,2021-01-16,7,2021,"2",623989,149,7,126,23,142,1.12181464737359,3.68596241279894,0.182539682539683
"United States","Vermont","VT",2021-01-17,2021-01-23,7,2021,"3",623989,145,7,124,21,138,1.12181464737359,3.36544394212077,0.169354838709677
"United States","Vermont","VT",2021-01-24,2021-01-30,7,2021,"4",623989,116,3,127,-11,113,0.480777706017254,-1.76285158872993,-0.0866141732283464
"United States","Vermont","VT",2021-01-31,2021-02-06,7,2021,"5",623989,154,9,121,33,145,1.44233311805176,5.28855476618979,0.272727272727273
"United States","Vermont","VT",2021-02-07,2021-02-13,7,2021,"6",623989,127,7,118,9,120,1.12181464737359,1.44233311805176,0.076271186440678
"United States","Vermont","VT",2021-02-14,2021-02-20,7,2021,"7",623989,156,7,113,43,149,1.12181464737359,6.89114711958063,0.380530973451327
"United States","Vermont","VT",2021-02-21,2021-02-27,7,2021,"8",623989,158,9,120,38,149,1.44233311805176,6.08985094288521,0.316666666666667
"United States","Vermont","VT",2021-02-28,2021-03-06,7,2021,"9",623989,110,3,116,-6,107,0.480777706017254,-0.961555412034507,-0.0517241379310345
"United States","Vermont","VT",2021-03-07,2021-03-13,7,2021,"10",623989,132,6,119,13,126,0.961555412034507,2.0833700594081,0.109243697478992
"United States","Vermont","VT",2021-03-14,2021-03-20,7,2021,"11",623989,106,5,119,-13,101,0.801296176695423,-2.0833700594081,-0.109243697478992
"United States","Vermont","VT",2021-03-21,2021-03-27,7,2021,"12",623989,125,5,114,11,120,0.801296176695423,1.76285158872993,0.0964912280701755
"United States","Vermont","VT",2021-03-28,2021-04-03,7,2021,"13",623989,126,5,111,15,121,0.801296176695423,2.40388853008627,0.135135135135135
"United States","Vermont","VT",2021-04-04,2021-04-10,7,2021,"14",623989,107,2,117,-10,105,0.320518470678169,-1.60259235339085,-0.0854700854700855
"United States","Vermont","VT",2021-04-11,2021-04-17,7,2021,"15",623989,111,11,112,-1,100,1.76285158872993,-0.160259235339084,-0.0089285714285714
"United States","Vermont","VT",2021-04-18,2021-04-24,7,2021,"16",623989,141,2,112,29,139,0.320518470678169,4.64751782483345,0.258928571428571
"United States","Vermont","VT",2021-04-25,2021-05-01,7,2021,"17",623989,139,3,111,28,136,0.480777706017254,4.48725858949437,0.252252252252252
"United States","Vermont","VT",2021-05-02,2021-05-08,7,2021,"18",623989,118,2,102,16,116,0.320518470678169,2.56414776542535,0.156862745098039
"United States","Vermont","VT",2021-05-09,2021-05-15,7,2021,"19",623989,130,3,102,28,127,0.480777706017254,4.48725858949437,0.274509803921569
"United States","Vermont","VT",2021-05-16,2021-05-22,7,2021,"20",623989,112,3,100,12,109,0.480777706017254,1.92311082406901,0.12
"United States","Vermont","VT",2021-05-23,2021-05-29,7,2021,"21",623989,115,0,103,12,115,0,1.92311082406901,0.116504854368932
"United States","Vermont","VT",2021-05-30,2021-06-05,7,2021,"22",623989,102,1,108,-6,101,0.160259235339084,-0.961555412034507,-0.0555555555555556
"United States","Vermont","VT",2021-06-06,2021-06-12,7,2021,"23",623989,116,0,108,8,116,0,1.28207388271268,0.0740740740740742
"United States","Vermont","VT",2021-06-13,2021-06-19,7,2021,"24",623989,116,0,107,9,116,0,1.44233311805176,0.0841121495327102
"United States","Vermont","VT",2021-06-20,2021-06-26,7,2021,"25",623989,113,0,107,6,113,0,0.961555412034507,0.0560747663551402
"United States","Vermont","VT",2021-06-27,2021-07-03,7,2021,"26",623989,114,2,108,6,112,0.320518470678169,0.961555412034507,0.0555555555555556
"United States","Vermont","VT",2021-07-04,2021-07-10,7,2021,"27",623989,110,0,105,5,110,0,0.801296176695423,0.0476190476190477
"United States","Virginia","VA",2019-12-29,2020-01-04,7,2020,"1",8535519,1438,0,1494,-56,1438,0,-0.656081955883409,-0.0374832663989291
"United States","Virginia","VA",2020-01-05,2020-01-11,7,2020,"2",8535519,1562,0,1504,58,1562,0,0.679513454307817,0.0385638297872339
"United States","Virginia","VA",2020-01-12,2020-01-18,7,2020,"3",8535519,1466,0,1491,-25,1466,0,-0.292893730305093,-0.0167672702883971
"United States","Virginia","VA",2020-01-19,2020-01-25,7,2020,"4",8535519,1459,0,1491,-32,1459,0,-0.374903974790519,-0.0214621059691482
"United States","Virginia","VA",2020-01-26,2020-02-01,7,2020,"5",8535519,1479,0,1471,8,1479,0,0.0937259936976299,0.00543847722637669
"United States","Virginia","VA",2020-02-02,2020-02-08,7,2020,"6",8535519,1524,0,1462,62,1524,0,0.726376451156632,0.042407660738714
"United States","Virginia","VA",2020-02-09,2020-02-15,7,2020,"7",8535519,1377,0,1459,-82,1377,0,-0.960691435400706,-0.0562028786840302
"United States","Virginia","VA",2020-02-16,2020-02-22,7,2020,"8",8535519,1444,0,1447,-3,1444,0,-0.0351472476366112,-0.00207325501036626
"United States","Virginia","VA",2020-02-23,2020-02-29,7,2020,"9",8535519,1388,0,1422,-34,1388,0,-0.398335473214927,-0.0239099859353024
"United States","Virginia","VA",2020-03-01,2020-03-07,7,2020,"10",8535519,1480,0,1425,55,1480,0,0.644366206671205,0.0385964912280701
"United States","Virginia","VA",2020-03-08,2020-03-14,7,2020,"11",8535519,1435,1,1420,15,1434,0.0117157492122037,0.175736238183056,0.0105633802816902
"United States","Virginia","VA",2020-03-15,2020-03-21,7,2020,"12",8535519,1455,1,1404,51,1454,0.0117157492122037,0.59750320982239,0.0363247863247864
"United States","Virginia","VA",2020-03-22,2020-03-28,7,2020,"13",8535519,1517,15,1388,129,1502,0.175736238183056,1.51133164837428,0.0929394812680115
"United States","Virginia","VA",2020-03-29,2020-04-04,7,2020,"14",8535519,1467,32,1377,90,1435,0.374903974790519,1.05441742909834,0.065359477124183
"United States","Virginia","VA",2020-04-05,2020-04-11,7,2020,"15",8535519,1619,80,1358,261,1539,0.937259936976299,3.05781054438517,0.19219440353461
"United States","Virginia","VA",2020-04-12,2020-04-18,7,2020,"16",8535519,1602,128,1341,261,1474,1.49961589916208,3.05781054438517,0.194630872483222
"United States","Virginia","VA",2020-04-19,2020-04-25,7,2020,"17",8535519,1633,179,1333,300,1454,2.09711910898447,3.51472476366112,0.225056264066017
"United States","Virginia","VA",2020-04-26,2020-05-02,7,2020,"18",8535519,1669,181,1319,350,1488,2.12055060740888,4.10051222427131,0.265352539802881
"United States","Virginia","VA",2020-05-03,2020-05-09,7,2020,"19",8535519,1593,211,1302,291,1382,2.47202308377499,3.40928302075129,0.223502304147466
"United States","Virginia","VA",2020-05-10,2020-05-16,7,2020,"20",8535519,1565,174,1292,273,1391,2.03854036292345,3.19839953493162,0.211300309597523
"United States","Virginia","VA",2020-05-17,2020-05-23,7,2020,"21",8535519,1464,156,1299,165,1308,1.82765687710378,1.93309862001362,0.1270207852194
"United States","Virginia","VA",2020-05-24,2020-05-30,7,2020,"22",8535519,1443,206,1296,147,1237,2.41344433771397,1.72221513419395,0.113425925925926
"United States","Virginia","VA",2020-05-31,2020-06-06,7,2020,"23",8535519,1410,89,1288,122,1321,1.04270167988613,1.42932140388886,0.09472049689441
"United States","Virginia","VA",2020-06-07,2020-06-13,7,2020,"24",8535519,1422,83,1284,138,1339,0.97240718461291,1.61677339128412,0.107476635514019
"United States","Virginia","VA",2020-06-14,2020-06-20,7,2020,"25",8535519,1292,68,1275,17,1224,0.796670946429854,0.199167736607463,0.0133333333333334
"United States","Virginia","VA",2020-06-21,2020-06-27,7,2020,"26",8535519,1456,120,1273,183,1336,1.40588990546445,2.14398210583328,0.143754909662215
"United States","Virginia","VA",2020-06-28,2020-07-04,7,2020,"27",8535519,1394,124,1269,125,1270,1.45275290231326,1.46446865152547,0.0985027580772262
"United States","Virginia","VA",2020-07-05,2020-07-11,7,2020,"28",8535519,1488,118,1264,224,1370,1.38245840704004,2.62432782353364,0.177215189873418
"United States","Virginia","VA",2020-07-12,2020-07-18,7,2020,"29",8535519,1390,61,1266,124,1329,0.714660701944428,1.45275290231326,0.0979462875197472
"United States","Virginia","VA",2020-07-19,2020-07-25,7,2020,"30",8535519,1463,48,1264,199,1415,0.562355962185779,2.33143409322854,0.15743670886076
"United States","Virginia","VA",2020-07-26,2020-08-01,7,2020,"31",8535519,1455,140,1259,196,1315,1.64020488970852,2.29628684559193,0.155679110405083
"United States","Virginia","VA",2020-08-02,2020-08-08,7,2020,"32",8535519,1513,107,1251,262,1406,1.2535851657058,3.06952629359738,0.209432454036771
"United States","Virginia","VA",2020-08-09,2020-08-15,7,2020,"33",8535519,1457,59,1249,208,1398,0.69122920352002,2.43687583613838,0.166533226581265
"United States","Virginia","VA",2020-08-16,2020-08-22,7,2020,"34",8535519,1454,62,1255,199,1392,0.726376451156632,2.33143409322854,0.158565737051793
"United States","Virginia","VA",2020-08-23,2020-08-29,7,2020,"35",8535519,1458,125,1246,212,1333,1.46446865152547,2.48373883298719,0.170144462279294
"United States","Virginia","VA",2020-08-30,2020-09-05,7,2020,"36",8535519,1486,109,1248,238,1377,1.27701666413021,2.78834831250449,0.190705128205128
"United States","Virginia","VA",2020-09-06,2020-09-12,7,2020,"37",8535519,1469,45,1255,214,1424,0.527208714549168,2.5071703314116,0.170517928286853
"United States","Virginia","VA",2020-09-13,2020-09-19,7,2020,"38",8535519,1459,268,1261,198,1191,3.1398207888706,2.31971834401634,0.157018239492466
"United States","Virginia","VA",2020-09-20,2020-09-26,7,2020,"39",8535519,1484,154,1269,215,1330,1.80422537867937,2.5188860806238,0.169424743892829
"United States","Virginia","VA",2020-09-27,2020-10-03,7,2020,"40",8535519,1516,126,1289,227,1390,1.47618440073767,2.65947507117025,0.17610550814585
"United States","Virginia","VA",2020-10-04,2020-10-10,7,2020,"41",8535519,1478,84,1302,176,1394,0.984122933825114,2.06197186134786,0.135176651305684
"United States","Virginia","VA",2020-10-11,2020-10-17,7,2020,"42",8535519,1448,68,1314,134,1380,0.796670946429854,1.5699103944353,0.101978691019787
"United States","Virginia","VA",2020-10-18,2020-10-24,7,2020,"43",8535519,1496,156,1316,180,1340,1.82765687710378,2.10883485819667,0.13677811550152
"United States","Virginia","VA",2020-10-25,2020-10-31,7,2020,"44",8535519,1546,60,1332,214,1486,0.702944952732224,2.5071703314116,0.160660660660661
"United States","Virginia","VA",2020-11-01,2020-11-07,7,2020,"45",8535519,1652,59,1336,316,1593,0.69122920352002,3.70217675105638,0.236526946107784
"United States","Virginia","VA",2020-11-08,2020-11-14,7,2020,"46",8535519,1513,90,1340,173,1423,1.05441742909834,2.02682461371125,0.12910447761194
"United States","Virginia","VA",2020-11-15,2020-11-21,7,2020,"47",8535519,1614,120,1344,270,1494,1.40588990546445,3.16325228729501,0.200892857142857
"United States","Virginia","VA",2020-11-22,2020-11-28,7,2020,"48",8535519,1595,144,1361,234,1451,1.68706788655734,2.74148531565567,0.171932402645114
"United States","Virginia","VA",2020-11-29,2020-12-05,7,2020,"49",8535519,1629,143,1374,255,1486,1.67535213734513,2.98751604911195,0.185589519650655
"United States","Virginia","VA",2020-12-06,2020-12-12,7,2020,"50",8535519,1795,215,1389,406,1580,2.5188860806238,4.75659418015472,0.292296616270698
"United States","Virginia","VA",2020-12-13,2020-12-19,7,2020,"51",8535519,1868,233,1399,469,1635,2.72976956644347,5.49468638052355,0.335239456754825
"United States","Virginia","VA",2020-12-20,2020-12-26,7,2020,"52",8535519,1901,193,1414,487,1708,2.26113959795532,5.70556986634322,0.344413012729844
"United States","Virginia","VA",2020-12-27,2021-01-02,7,2020,"53",8535519,2016,280,1421,595,1736,3.28040977941705,6.97087078126122,0.41871921182266
"United States","Virginia","VA",2021-01-03,2021-01-09,7,2021,"1",8535519,2015,266,1435,580,1749,3.11638929044619,6.79513454307816,0.40418118466899
"United States","Virginia","VA",2021-01-10,2021-01-16,7,2021,"2",8535519,2065,323,1455,610,1742,3.78418699554181,7.14660701944428,0.419243986254296
"United States","Virginia","VA",2021-01-17,2021-01-23,7,2021,"3",8535519,2123,371,1471,652,1752,4.34654295772758,7.63866848635683,0.443235893949694
"United States","Virginia","VA",2021-01-24,2021-01-30,7,2021,"4",8535519,1963,374,1483,480,1589,4.3816902053642,5.62355962185779,0.323668240053945
"United States","Virginia","VA",2021-01-31,2021-02-06,7,2021,"5",8535519,2008,325,1480,528,1683,3.80761849396621,6.18591558404357,0.356756756756757
"United States","Virginia","VA",2021-02-07,2021-02-13,7,2021,"6",8535519,1805,228,1481,324,1577,2.67119082038245,3.79590274475401,0.218771100607698
"United States","Virginia","VA",2021-02-14,2021-02-20,7,2021,"7",8535519,1742,209,1469,273,1533,2.44859158535058,3.19839953493162,0.185840707964602
"United States","Virginia","VA",2021-02-21,2021-02-27,7,2021,"8",8535519,1713,1173,1455,258,540,13.742573825915,3.02266329674856,0.177319587628866
"United States","Virginia","VA",2021-02-28,2021-03-06,7,2021,"9",8535519,1594,1140,1446,148,454,13.3559541019123,1.73393088340615,0.102351313969571
"United States","Virginia","VA",2021-03-07,2021-03-13,7,2021,"10",8535519,1553,477,1448,105,1076,5.58841237422118,1.23015366728139,0.0725138121546962
"United States","Virginia","VA",2021-03-14,2021-03-20,7,2021,"11",8535519,1528,209,1438,90,1319,2.44859158535058,1.05441742909834,0.0625869262865091
"United States","Virginia","VA",2021-03-21,2021-03-27,7,2021,"12",8535519,1533,62,1430,103,1471,0.726376451156632,1.20672216885698,0.072027972027972
"United States","Virginia","VA",2021-03-28,2021-04-03,7,2021,"13",8535519,1368,15,1427,-59,1353,0.175736238183056,-0.69122920352002,-0.0413454800280308
"United States","Virginia","VA",2021-04-04,2021-04-10,7,2021,"14",8535519,1577,171,1410,167,1406,2.00339311528684,1.95653011843802,0.118439716312057
"United States","Virginia","VA",2021-04-11,2021-04-17,7,2021,"15",8535519,1434,106,1400,34,1328,1.2418694164936,0.398335473214927,0.0242857142857142
"United States","Virginia","VA",2021-04-18,2021-04-24,7,2021,"16",8535519,1493,111,1385,108,1382,1.30044816255461,1.265300914918,0.0779783393501805
"United States","Virginia","VA",2021-04-25,2021-05-01,7,2021,"17",8535519,1498,102,1365,133,1396,1.19500641964478,1.5581946452231,0.0974358974358975
"United States","Virginia","VA",2021-05-02,2021-05-08,7,2021,"18",8535519,1490,108,1338,152,1382,1.265300914918,1.78079388025497,0.113602391629297
"United States","Virginia","VA",2021-05-09,2021-05-15,7,2021,"19",8535519,1481,123,1334,147,1358,1.44103715310106,1.72221513419395,0.110194902548726
"United States","Virginia","VA",2021-05-16,2021-05-22,7,2021,"20",8535519,1405,89,1332,73,1316,1.04270167988613,0.855249692490872,0.0548048048048049
"United States","Virginia","VA",2021-05-23,2021-05-29,7,2021,"21",8535519,1446,63,1329,117,1383,0.738092200368835,1.37074265782784,0.0880361173814899
"United States","Virginia","VA",2021-05-30,2021-06-05,7,2021,"22",8535519,1463,69,1331,132,1394,0.808386695642058,1.54647889601089,0.0991735537190082
"United States","Virginia","VA",2021-06-06,2021-06-12,7,2021,"23",8535519,1420,64,1322,98,1356,0.749807949581039,1.14814342279597,0.0741301059001513
"United States","Virginia","VA",2021-06-13,2021-06-19,7,2021,"24",8535519,1347,50,1315,32,1297,0.585787460610187,0.374903974790519,0.0243346007604563
"United States","Virginia","VA",2021-06-20,2021-06-26,7,2021,"25",8535519,1345,49,1320,25,1296,0.574071711397983,0.292893730305093,0.018939393939394
"United States","Virginia","VA",2021-06-27,2021-07-03,7,2021,"26",8535519,1331,31,1318,13,1300,0.363188225578316,0.152304739758649,0.00986342943854335
"United States","Virginia","VA",2021-07-04,2021-07-10,7,2021,"27",8535519,1129,27,1305,-176,1102,0.316325228729501,-2.06197186134786,-0.134865900383142
"United States","Washington","WA",2019-12-29,2020-01-04,7,2020,"1",7614893,1183,0,1275,-92,1183,0,-1.20815880144343,-0.072156862745098
"United States","Washington","WA",2020-01-05,2020-01-11,7,2020,"2",7614893,1246,0,1295,-49,1246,0,-0.643475883377482,-0.0378378378378378
"United States","Washington","WA",2020-01-12,2020-01-18,7,2020,"3",7614893,1221,0,1291,-70,1221,0,-0.919251261967831,-0.0542215336948102
"United States","Washington","WA",2020-01-19,2020-01-25,7,2020,"4",7614893,1192,0,1273,-81,1192,0,-1.06370503170563,-0.0636292223095051
"United States","Washington","WA",2020-01-26,2020-02-01,7,2020,"5",7614893,1200,0,1243,-43,1200,0,-0.564682918065953,-0.0345937248592116
"United States","Washington","WA",2020-02-02,2020-02-08,7,2020,"6",7614893,1180,0,1236,-56,1180,0,-0.735401009574265,-0.0453074433656958
"United States","Washington","WA",2020-02-09,2020-02-15,7,2020,"7",7614893,1179,0,1226,-47,1179,0,-0.617211561606972,-0.0383360522022839
"United States","Washington","WA",2020-02-16,2020-02-22,7,2020,"8",7614893,1115,0,1209,-94,1115,0,-1.23442312321394,-0.0777502067824648
"United States","Washington","WA",2020-02-23,2020-02-29,7,2020,"9",7614893,1135,1,1202,-67,1134,0.0131321608852547,-0.879854779312066,-0.0557404326123128
"United States","Washington","WA",2020-03-01,2020-03-07,7,2020,"10",7614893,1208,15,1211,-3,1193,0.196982413278821,-0.0393964826557642,-0.00247729149463249
"United States","Washington","WA",2020-03-08,2020-03-14,7,2020,"11",7614893,1165,24,1201,-36,1141,0.315171861246113,-0.47275779186917,-0.0299750208159867
"United States","Washington","WA",2020-03-15,2020-03-21,7,2020,"12",7614893,1224,53,1180,44,1171,0.6960045269185,0.577815078951208,0.0372881355932204
"United States","Washington","WA",2020-03-22,2020-03-28,7,2020,"13",7614893,1294,91,1170,124,1203,1.19502664055818,1.62838794977159,0.105982905982906
"United States","Washington","WA",2020-03-29,2020-04-04,7,2020,"14",7614893,1305,126,1157,148,1179,1.6546522715421,1.9435598110177,0.127917026793431
"United States","Washington","WA",2020-04-05,2020-04-11,7,2020,"15",7614893,1304,181,1146,158,1123,2.3769211202311,2.07488141987025,0.137870855148342
"United States","Washington","WA",2020-04-12,2020-04-18,7,2020,"16",7614893,1251,133,1124,127,1118,1.74657739773888,1.66778443242735,0.112989323843416
"United States","Washington","WA",2020-04-19,2020-04-25,7,2020,"17",7614893,1231,114,1110,121,1117,1.49706634091904,1.58899146711582,0.109009009009009
"United States","Washington","WA",2020-04-26,2020-05-02,7,2020,"18",7614893,1157,91,1088,69,1066,1.19502664055818,0.906119101082576,0.0634191176470589
"United States","Washington","WA",2020-05-03,2020-05-09,7,2020,"19",7614893,1211,91,1087,124,1120,1.19502664055818,1.62838794977159,0.114075436982521
"United States","Washington","WA",2020-05-10,2020-05-16,7,2020,"20",7614893,1138,79,1087,51,1059,1.03744070993512,0.669740205147991,0.0469181232750691
"United States","Washington","WA",2020-05-17,2020-05-23,7,2020,"21",7614893,1114,51,1096,18,1063,0.669740205147991,0.236378895934585,0.0164233576642336
"United States","Washington","WA",2020-05-24,2020-05-30,7,2020,"22",7614893,1058,68,1087,-29,990,0.892986940197321,-0.380832665672387,-0.0266789328426863
"United States","Washington","WA",2020-05-31,2020-06-06,7,2020,"23",7614893,1055,35,1075,-20,1020,0.459625630983915,-0.262643217705094,-0.0186046511627908
"United States","Washington","WA",2020-06-07,2020-06-13,7,2020,"24",7614893,1101,59,1069,32,1042,0.774797492230029,0.420229148328151,0.0299345182413471
"United States","Washington","WA",2020-06-14,2020-06-20,7,2020,"25",7614893,1133,51,1088,45,1082,0.669740205147991,0.590947239836463,0.041360294117647
"United States","Washington","WA",2020-06-21,2020-06-27,7,2020,"26",7614893,1084,47,1083,1,1037,0.617211561606972,0.0131321608852547,0.000923361034164349
"United States","Washington","WA",2020-06-28,2020-07-04,7,2020,"27",7614893,1126,44,1072,54,1082,0.577815078951208,0.709136687803755,0.0503731343283582
"United States","Washington","WA",2020-07-05,2020-07-11,7,2020,"28",7614893,1162,70,1066,96,1092,0.919251261967831,1.26068744498445,0.0900562851782365
"United States","Washington","WA",2020-07-12,2020-07-18,7,2020,"29",7614893,1180,20,1069,111,1160,0.262643217705094,1.45766985826327,0.103835360149673
"United States","Washington","WA",2020-07-19,2020-07-25,7,2020,"30",7614893,1180,50,1059,121,1130,0.656608044262736,1.58899146711582,0.114258734655335
"United States","Washington","WA",2020-07-26,2020-08-01,7,2020,"31",7614893,1229,98,1046,183,1131,1.28695176675496,2.40318544200161,0.174952198852772
"United States","Washington","WA",2020-08-02,2020-08-08,7,2020,"32",7614893,1234,80,1046,188,1154,1.05057287082038,2.46884624642789,0.179732313575526
"United States","Washington","WA",2020-08-09,2020-08-15,7,2020,"33",7614893,1174,94,1036,138,1080,1.23442312321394,1.81223820216515,0.133204633204633
"United States","Washington","WA",2020-08-16,2020-08-22,7,2020,"34",7614893,1199,91,1038,161,1108,1.19502664055818,2.11427790252601,0.155105973025048
"United States","Washington","WA",2020-08-23,2020-08-29,7,2020,"35",7614893,1118,48,1037,81,1070,0.630343722492227,1.06370503170563,0.0781099324975891
"United States","Washington","WA",2020-08-30,2020-09-05,7,2020,"36",7614893,1240,48,1033,207,1192,0.630343722492227,2.71835730324773,0.200387221684414
"United States","Washington","WA",2020-09-06,2020-09-12,7,2020,"37",7614893,1146,38,1043,103,1108,0.499022113639679,1.35261257118124,0.0987535953978906
"United States","Washington","WA",2020-09-13,2020-09-19,7,2020,"38",7614893,1178,45,1041,137,1133,0.590947239836463,1.7991060412799,0.131604226705091
"United States","Washington","WA",2020-09-20,2020-09-26,7,2020,"39",7614893,1168,62,1043,125,1106,0.814193974885793,1.64152011065684,0.119846596356664
"United States","Washington","WA",2020-09-27,2020-10-03,7,2020,"40",7614893,1143,45,1067,76,1098,0.590947239836463,0.998044227279359,0.0712277413308342
"United States","Washington","WA",2020-10-04,2020-10-10,7,2020,"41",7614893,1162,47,1075,87,1115,0.617211561606972,1.14249799701716,0.0809302325581396
"United States","Washington","WA",2020-10-11,2020-10-17,7,2020,"42",7614893,1149,49,1099,50,1100,0.643475883377482,0.656608044262736,0.0454959053685169
"United States","Washington","WA",2020-10-18,2020-10-24,7,2020,"43",7614893,1195,47,1091,104,1148,0.617211561606972,1.36574473206649,0.0953253895508708
"United States","Washington","WA",2020-10-25,2020-10-31,7,2020,"44",7614893,1194,79,1090,104,1115,1.03744070993512,1.36574473206649,0.0954128440366973
"United States","Washington","WA",2020-11-01,2020-11-07,7,2020,"45",7614893,1274,72,1096,178,1202,0.94551558373834,2.33752463757534,0.162408759124088
"United States","Washington","WA",2020-11-08,2020-11-14,7,2020,"46",7614893,1313,77,1113,200,1236,1.01117638816461,2.62643217705094,0.179694519317161
"United States","Washington","WA",2020-11-15,2020-11-21,7,2020,"47",7614893,1325,100,1102,223,1225,1.31321608852547,2.9284718774118,0.202359346642468
"United States","Washington","WA",2020-11-22,2020-11-28,7,2020,"48",7614893,1246,81,1115,131,1165,1.06370503170563,1.72031307596837,0.117488789237668
"United States","Washington","WA",2020-11-29,2020-12-05,7,2020,"49",7614893,1354,137,1120,234,1217,1.7991060412799,3.07292564714961,0.208928571428571
"United States","Washington","WA",2020-12-06,2020-12-12,7,2020,"50",7614893,1412,47,1140,272,1365,0.617211561606972,3.57194776078929,0.23859649122807
"United States","Washington","WA",2020-12-13,2020-12-19,7,2020,"51",7614893,1381,225,1169,212,1156,2.95473619918231,2.784018107674,0.181351582549187
"United States","Washington","WA",2020-12-20,2020-12-26,7,2020,"52",7614893,1392,27,1199,193,1365,0.354568343901878,2.53450705085416,0.160967472894078
"United States","Washington","WA",2020-12-27,2021-01-02,7,2020,"53",7614893,1348,56,1234,114,1292,0.735401009574265,1.49706634091904,0.0923824959481361
"United States","Washington","WA",2021-01-03,2021-01-09,7,2021,"1",7614893,1426,447,1258,168,979,5.87007591570886,2.20620302872279,0.133545310015898
"United States","Washington","WA",2021-01-10,2021-01-16,7,2021,"2",7614893,1391,209,1270,121,1182,2.74462162501824,1.58899146711582,0.0952755905511811
"United States","Washington","WA",2021-01-17,2021-01-23,7,2021,"3",7614893,1306,269,1263,43,1037,3.53255127813352,0.564682918065953,0.0340459224069676
"United States","Washington","WA",2021-01-24,2021-01-30,7,2021,"4",7614893,1341,173,1258,83,1168,2.27186383314907,1.08996935347614,0.0659777424483308
"United States","Washington","WA",2021-01-31,2021-02-06,7,2021,"5",7614893,1355,164,1254,101,1191,2.15367438518177,1.32634824941073,0.0805422647527911
"United States","Washington","WA",2021-02-07,2021-02-13,7,2021,"6",7614893,1248,226,1253,-5,1022,2.96786836006757,-0.0656608044262736,-0.00399042298483643
"United States","Washington","WA",2021-02-14,2021-02-20,7,2021,"7",7614893,1265,148,1257,8,1117,1.9435598110177,0.105057287082038,0.00636435958631654
"United States","Washington","WA",2021-02-21,2021-02-27,7,2021,"8",7614893,1244,134,1257,-13,1110,1.75970955862413,-0.170718091508311,-0.0103420843277645
"United States","Washington","WA",2021-02-28,2021-03-06,7,2021,"9",7614893,1251,89,1252,-1,1162,1.16876231878767,-0.0131321608852547,-0.000798722044728417
"United States","Washington","WA",2021-03-07,2021-03-13,7,2021,"10",7614893,1201,85,1246,-45,1116,1.11623367524665,-0.590947239836463,-0.036115569823435
"United States","Washington","WA",2021-03-14,2021-03-20,7,2021,"11",7614893,1173,47,1241,-68,1126,0.617211561606972,-0.892986940197321,-0.0547945205479452
"United States","Washington","WA",2021-03-21,2021-03-27,7,2021,"12",7614893,1219,43,1225,-6,1176,0.564682918065953,-0.0787929653115283,-0.00489795918367342
"United States","Washington","WA",2021-03-28,2021-04-03,7,2021,"13",7614893,1187,58,1217,-30,1129,0.761665331344774,-0.393964826557642,-0.0246507806080526
"United States","Washington","WA",2021-04-04,2021-04-10,7,2021,"14",7614893,1221,43,1185,36,1178,0.564682918065953,0.47275779186917,0.030379746835443
"United States","Washington","WA",2021-04-11,2021-04-17,7,2021,"15",7614893,1204,58,1165,39,1146,0.761665331344774,0.512154274524934,0.0334763948497854
"United States","Washington","WA",2021-04-18,2021-04-24,7,2021,"16",7614893,1214,54,1155,59,1160,0.709136687803755,0.774797492230029,0.0510822510822511
"United States","Washington","WA",2021-04-25,2021-05-01,7,2021,"17",7614893,1233,65,1137,96,1168,0.853590457541557,1.26068744498445,0.0844327176781003
"United States","Washington","WA",2021-05-02,2021-05-08,7,2021,"18",7614893,1213,65,1130,83,1148,0.853590457541557,1.08996935347614,0.0734513274336284
"United States","Washington","WA",2021-05-09,2021-05-15,7,2021,"19",7614893,1192,58,1123,69,1134,0.761665331344774,0.906119101082576,0.0614425645592165
"United States","Washington","WA",2021-05-16,2021-05-22,7,2021,"20",7614893,1159,80,1123,36,1079,1.05057287082038,0.47275779186917,0.0320569902048085
"United States","Washington","WA",2021-05-23,2021-05-29,7,2021,"21",7614893,1213,63,1118,95,1150,0.827326135771048,1.2475552840992,0.0849731663685152
"United States","Washington","WA",2021-05-30,2021-06-05,7,2021,"22",7614893,1258,71,1099,159,1187,0.932383422853086,2.0880135807555,0.144676979071884
"United States","Washington","WA",2021-06-06,2021-06-12,7,2021,"23",7614893,1267,-21,1096,171,1288,-0.275775378590349,2.24559951137856,0.156021897810219
"United States","Washington","WA",2021-06-13,2021-06-19,7,2021,"24",7614893,1161,5,1098,63,1156,0.0656608044262736,0.827326135771048,0.0573770491803278
"United States","Washington","WA",2021-06-20,2021-06-26,7,2021,"25",7614893,1220,82,1106,114,1138,1.07683719259089,1.49706634091904,0.103074141048825
"United States","Washington","WA",2021-06-27,2021-07-03,7,2021,"26",7614893,1379,37,1102,277,1342,0.485889952754425,3.63760856521556,0.251361161524501
"United States","Washington","WA",2021-07-04,2021-07-10,7,2021,"27",7614893,818,58,1102,-284,760,0.761665331344774,-3.72953369141234,-0.257713248638838
"United States","West Virginia","WV",2019-12-29,2020-01-04,7,2020,"1",1792147,474,0,513,-39,474,0,-2.17616077252591,-0.0760233918128655
"United States","West Virginia","WV",2020-01-05,2020-01-11,7,2020,"2",1792147,494,0,517,-23,494,0,-1.28337686584862,-0.0444874274661509
"United States","West Virginia","WV",2020-01-12,2020-01-18,7,2020,"3",1792147,520,0,514,6,520,0,0.334793965003987,0.0116731517509727
"United States","West Virginia","WV",2020-01-19,2020-01-25,7,2020,"4",1792147,442,0,500,-58,442,0,-3.23634166170521,-0.116
"United States","West Virginia","WV",2020-01-26,2020-02-01,7,2020,"5",1792147,482,0,489,-7,482,0,-0.390592959171318,-0.0143149284253579
"United States","West Virginia","WV",2020-02-02,2020-02-08,7,2020,"6",1792147,482,0,485,-3,482,0,-0.167396982501993,-0.00618556701030926
"United States","West Virginia","WV",2020-02-09,2020-02-15,7,2020,"7",1792147,478,0,482,-4,478,0,-0.223195976669325,-0.00829875518672196
"United States","West Virginia","WV",2020-02-16,2020-02-22,7,2020,"8",1792147,467,0,475,-8,467,0,-0.446391953338649,-0.0168421052631579
"United States","West Virginia","WV",2020-02-23,2020-02-29,7,2020,"9",1792147,460,0,468,-8,460,0,-0.446391953338649,-0.0170940170940171
"United States","West Virginia","WV",2020-03-01,2020-03-07,7,2020,"10",1792147,483,0,468,15,483,0,0.836984912509967,0.0320512820512822
"United States","West Virginia","WV",2020-03-08,2020-03-14,7,2020,"11",1792147,475,0,471,4,475,0,0.223195976669325,0.00849256900212314
"United States","West Virginia","WV",2020-03-15,2020-03-21,7,2020,"12",1792147,470,0,471,-1,470,0,-0.0557989941673311,-0.00212314225053079
"United States","West Virginia","WV",2020-03-22,2020-03-28,7,2020,"13",1792147,491,0,473,18,491,0,1.00438189501196,0.0380549682875264
"United States","West Virginia","WV",2020-03-29,2020-04-04,7,2020,"14",1792147,467,2,476,-9,465,0.111597988334662,-0.50219094750598,-0.0189075630252101
"United States","West Virginia","WV",2020-04-05,2020-04-11,7,2020,"15",1792147,523,4,465,58,519,0.223195976669325,3.23634166170521,0.124731182795699
"United States","West Virginia","WV",2020-04-12,2020-04-18,7,2020,"16",1792147,419,12,461,-42,407,0.669587930007974,-2.34355775502791,-0.0911062906724512
"United States","West Virginia","WV",2020-04-19,2020-04-25,7,2020,"17",1792147,460,15,448,12,445,0.836984912509967,0.669587930007974,0.0267857142857142
"United States","West Virginia","WV",2020-04-26,2020-05-02,7,2020,"18",1792147,482,16,440,42,466,0.892783906677298,2.34355775502791,0.0954545454545455
"United States","West Virginia","WV",2020-05-03,2020-05-09,7,2020,"19",1792147,449,3,425,24,446,0.167396982501993,1.33917586001595,0.0564705882352941
"United States","West Virginia","WV",2020-05-10,2020-05-16,7,2020,"20",1792147,477,12,422,55,465,0.669587930007974,3.06894467920321,0.130331753554502
"United States","West Virginia","WV",2020-05-17,2020-05-23,7,2020,"21",1792147,440,7,423,17,433,0.390592959171318,0.948582900844629,0.0401891252955082
"United States","West Virginia","WV",2020-05-24,2020-05-30,7,2020,"22",1792147,412,2,425,-13,410,0.111597988334662,-0.725386924175305,-0.0305882352941177
"United States","West Virginia","WV",2020-05-31,2020-06-06,7,2020,"23",1792147,409,11,422,-13,398,0.613788935840643,-0.725386924175305,-0.0308056872037915
"United States","West Virginia","WV",2020-06-07,2020-06-13,7,2020,"24",1792147,458,4,424,34,454,0.223195976669325,1.89716580168926,0.0801886792452831
"United States","West Virginia","WV",2020-06-14,2020-06-20,7,2020,"25",1792147,419,0,418,1,419,0,0.0557989941673311,0.00239234449760772
"United States","West Virginia","WV",2020-06-21,2020-06-27,7,2020,"26",1792147,464,5,420,44,459,0.278994970836656,2.45515574336257,0.104761904761905
"United States","West Virginia","WV",2020-06-28,2020-07-04,7,2020,"27",1792147,425,1,417,8,424,0.0557989941673311,0.446391953338649,0.0191846522781776
"United States","West Virginia","WV",2020-07-05,2020-07-11,7,2020,"28",1792147,436,2,417,19,434,0.111597988334662,1.06018088917929,0.0455635491606714
"United States","West Virginia","WV",2020-07-12,2020-07-18,7,2020,"29",1792147,426,4,411,15,422,0.223195976669325,0.836984912509967,0.0364963503649636
"United States","West Virginia","WV",2020-07-19,2020-07-25,7,2020,"30",1792147,501,3,402,99,498,0.167396982501993,5.52410042256578,0.246268656716418
"United States","West Virginia","WV",2020-07-26,2020-08-01,7,2020,"31",1792147,474,13,394,80,461,0.725386924175305,4.46391953338649,0.203045685279188
"United States","West Virginia","WV",2020-08-02,2020-08-08,7,2020,"32",1792147,494,15,396,98,479,0.836984912509967,5.46830142839845,0.247474747474747
"United States","West Virginia","WV",2020-08-09,2020-08-15,7,2020,"33",1792147,462,29,399,63,433,1.6181708308526,3.51533663254186,0.157894736842105
"United States","West Virginia","WV",2020-08-16,2020-08-22,7,2020,"34",1792147,497,16,406,91,481,0.892783906677298,5.07770846922713,0.224137931034483
"United States","West Virginia","WV",2020-08-23,2020-08-29,7,2020,"35",1792147,442,36,413,29,406,2.00876379002392,1.6181708308526,0.0702179176755449
"United States","West Virginia","WV",2020-08-30,2020-09-05,7,2020,"36",1792147,460,31,418,42,429,1.72976881918727,2.34355775502791,0.100478468899522
"United States","West Virginia","WV",2020-09-06,2020-09-12,7,2020,"37",1792147,468,22,420,48,446,1.22757787168129,2.67835172003189,0.114285714285714
"United States","West Virginia","WV",2020-09-13,2020-09-19,7,2020,"38",1792147,484,43,416,68,441,2.39935674919524,3.79433160337852,0.163461538461539
"United States","West Virginia","WV",2020-09-20,2020-09-26,7,2020,"39",1792147,495,24,421,74,471,1.33917586001595,4.1291255683825,0.175771971496437
"United States","West Virginia","WV",2020-09-27,2020-10-03,7,2020,"40",1792147,424,25,423,1,399,1.39497485418328,0.0557989941673311,0.00236406619385332
"United States","West Virginia","WV",2020-10-04,2020-10-10,7,2020,"41",1792147,500,24,427,73,476,1.33917586001595,4.07332657421517,0.17096018735363
"United States","West Virginia","WV",2020-10-11,2020-10-17,7,2020,"42",1792147,455,18,435,20,437,1.00438189501196,1.11597988334662,0.0459770114942528
"United States","West Virginia","WV",2020-10-18,2020-10-24,7,2020,"43",1792147,471,23,442,29,448,1.28337686584862,1.6181708308526,0.0656108597285068
"United States","West Virginia","WV",2020-10-25,2020-10-31,7,2020,"44",1792147,485,31,443,42,454,1.72976881918727,2.34355775502791,0.0948081264108351
"United States","West Virginia","WV",2020-11-01,2020-11-07,7,2020,"45",1792147,531,48,444,87,483,2.67835172003189,4.85451249255781,0.195945945945946
"United States","West Virginia","WV",2020-11-08,2020-11-14,7,2020,"46",1792147,554,72,445,109,482,4.01752758004784,6.08209036423909,0.244943820224719
"United States","West Virginia","WV",2020-11-15,2020-11-21,7,2020,"47",1792147,524,65,444,80,459,3.62693462087652,4.46391953338649,0.18018018018018
"United States","West Virginia","WV",2020-11-22,2020-11-28,7,2020,"48",1792147,570,80,448,122,490,4.46391953338649,6.8074772884144,0.272321428571429
"United States","West Virginia","WV",2020-11-29,2020-12-05,7,2020,"49",1792147,637,111,454,183,526,6.19368835257376,10.2112159326216,0.403083700440529
"United States","West Virginia","WV",2020-12-06,2020-12-12,7,2020,"50",1792147,647,137,456,191,510,7.64446220092437,10.6576078859602,0.418859649122807
"United States","West Virginia","WV",2020-12-13,2020-12-19,7,2020,"51",1792147,695,156,466,229,539,8.70464309010366,12.7779696643188,0.491416309012876
"United States","West Virginia","WV",2020-12-20,2020-12-26,7,2020,"52",1792147,669,6,475,194,663,0.334793965003987,10.8250048684622,0.408421052631579
"United States","West Virginia","WV",2020-12-27,2021-01-02,7,2020,"53",1792147,729,245,483,246,484,13.6707535709961,13.7265525651635,0.509316770186335
"United States","West Virginia","WV",2021-01-03,2021-01-09,7,2021,"1",1792147,719,197,492,227,522,10.9924018509642,12.6663716759842,0.461382113821138
"United States","West Virginia","WV",2021-01-10,2021-01-16,7,2021,"2",1792147,678,191,492,186,487,10.6576078859602,10.3786129151236,0.378048780487805
"United States","West Virginia","WV",2021-01-17,2021-01-23,7,2021,"3",1792147,607,111,490,117,496,6.19368835257376,6.52848231757774,0.238775510204082
"United States","West Virginia","WV",2021-01-24,2021-01-30,7,2021,"4",1792147,629,143,492,137,486,7.97925616592835,7.64446220092437,0.278455284552846
"United States","West Virginia","WV",2021-01-31,2021-02-06,7,2021,"5",1792147,593,104,481,112,489,5.80309539340244,6.24948734674109,0.232848232848233
"United States","West Virginia","WV",2021-02-07,2021-02-13,7,2021,"6",1792147,582,80,471,111,502,4.46391953338649,6.19368835257376,0.235668789808917
"United States","West Virginia","WV",2021-02-14,2021-02-20,7,2021,"7",1792147,513,17,468,45,496,0.948582900844629,2.5109547375299,0.0961538461538463
"United States","West Virginia","WV",2021-02-21,2021-02-27,7,2021,"8",1792147,493,75,469,24,418,4.18492456254984,1.33917586001595,0.0511727078891258
"United States","West Virginia","WV",2021-02-28,2021-03-06,7,2021,"9",1792147,506,27,465,41,479,1.50657284251794,2.28775876086058,0.0881720430107527
"United States","West Virginia","WV",2021-03-07,2021-03-13,7,2021,"10",1792147,488,212,476,12,276,11.8293867634742,0.669587930007974,0.0252100840336134
"United States","West Virginia","WV",2021-03-14,2021-03-20,7,2021,"11",1792147,501,75,474,27,426,4.18492456254984,1.50657284251794,0.0569620253164558
"United States","West Virginia","WV",2021-03-21,2021-03-27,7,2021,"12",1792147,510,34,475,35,476,1.89716580168926,1.95296479585659,0.0736842105263158
"United States","West Virginia","WV",2021-03-28,2021-04-03,7,2021,"13",1792147,475,59,477,-2,416,3.29214065587254,-0.111597988334662,-0.00419287211740038
"United States","West Virginia","WV",2021-04-04,2021-04-10,7,2021,"14",1792147,484,39,476,8,445,2.17616077252591,0.446391953338649,0.0168067226890756
"United States","West Virginia","WV",2021-04-11,2021-04-17,7,2021,"15",1792147,500,43,463,37,457,2.39935674919524,2.06456278419125,0.079913606911447
"United States","West Virginia","WV",2021-04-18,2021-04-24,7,2021,"16",1792147,458,37,456,2,421,2.06456278419125,0.111597988334662,0.0043859649122806
"United States","West Virginia","WV",2021-04-25,2021-05-01,7,2021,"17",1792147,511,-138,447,64,649,-7.7002611950917,3.57113562670919,0.143176733780761
"United States","West Virginia","WV",2021-05-02,2021-05-08,7,2021,"18",1792147,474,47,441,33,427,2.62255272586456,1.84136680752193,0.0748299319727892
"United States","West Virginia","WV",2021-05-09,2021-05-15,7,2021,"19",1792147,465,31,442,23,434,1.72976881918727,1.28337686584862,0.0520361990950227
"United States","West Virginia","WV",2021-05-16,2021-05-22,7,2021,"20",1792147,445,15,438,7,430,0.836984912509967,0.390592959171318,0.0159817351598173
"United States","West Virginia","WV",2021-05-23,2021-05-29,7,2021,"21",1792147,427,20,432,-5,407,1.11597988334662,-0.278994970836656,-0.0115740740740741
"United States","West Virginia","WV",2021-05-30,2021-06-05,7,2021,"22",1792147,398,21,432,-34,377,1.17177887751395,-1.89716580168926,-0.0787037037037037
"United States","Wisconsin","WI",2019-12-29,2020-01-04,7,2020,"1",5822434,1118,0,1158,-40,1118,0,-0.686997911869847,-0.0345423143350605
"United States","Wisconsin","WI",2020-01-05,2020-01-11,7,2020,"2",5822434,1060,0,1167,-107,1060,0,-1.83771941425184,-0.091688089117395
"United States","Wisconsin","WI",2020-01-12,2020-01-18,7,2020,"3",5822434,1133,0,1171,-38,1133,0,-0.652648016276354,-0.0324508966695133
"United States","Wisconsin","WI",2020-01-19,2020-01-25,7,2020,"4",5822434,1086,0,1164,-78,1086,0,-1.3396459281462,-0.0670103092783505
"United States","Wisconsin","WI",2020-01-26,2020-02-01,7,2020,"5",5822434,1176,0,1154,22,1176,0,0.377848851528416,0.0190641247833623
"United States","Wisconsin","WI",2020-02-02,2020-02-08,7,2020,"6",5822434,1056,0,1154,-98,1056,0,-1.68314488408112,-0.0849220103986135
"United States","Wisconsin","WI",2020-02-09,2020-02-15,7,2020,"7",5822434,1125,0,1140,-15,1125,0,-0.257624216951193,-0.0131578947368421
"United States","Wisconsin","WI",2020-02-16,2020-02-22,7,2020,"8",5822434,1162,0,1130,32,1162,0,0.549598329495878,0.0283185840707965
"United States","Wisconsin","WI",2020-02-23,2020-02-29,7,2020,"9",5822434,1136,0,1105,31,1136,0,0.532423381699131,0.0280542986425338
"United States","Wisconsin","WI",2020-03-01,2020-03-07,7,2020,"10",5822434,1116,0,1109,7,1116,0,0.120224634577223,0.00631199278629402
"United States","Wisconsin","WI",2020-03-08,2020-03-14,7,2020,"11",5822434,1105,0,1109,-4,1105,0,-0.0686997911869847,-0.00360685302073938
"United States","Wisconsin","WI",2020-03-15,2020-03-21,7,2020,"12",5822434,1115,4,1111,4,1111,0.0686997911869847,0.0686997911869847,0.0036003600360035
"United States","Wisconsin","WI",2020-03-22,2020-03-28,7,2020,"13",5822434,1146,9,1118,28,1137,0.154574530170716,0.480898538308893,0.0250447227191413
"United States","Wisconsin","WI",2020-03-29,2020-04-04,7,2020,"14",5822434,1221,43,1112,109,1178,0.738522755260085,1.87206930984533,0.0980215827338129
"United States","Wisconsin","WI",2020-04-05,2020-04-11,7,2020,"15",5822434,1171,81,1097,74,1090,1.39117077153644,1.27094613695922,0.0674567000911577
"United States","Wisconsin","WI",2020-04-12,2020-04-18,7,2020,"16",5822434,1152,74,1084,68,1078,1.27094613695922,1.16789645017874,0.0627306273062731
"United States","Wisconsin","WI",2020-04-19,2020-04-25,7,2020,"17",5822434,1026,55,1080,-54,971,0.944622128821039,-0.927447181024293,-0.05
"United States","Wisconsin","WI",2020-04-26,2020-05-02,7,2020,"18",5822434,1162,68,1065,97,1094,1.16789645017874,1.66596993628438,0.0910798122065728
"United States","Wisconsin","WI",2020-05-03,2020-05-09,7,2020,"19",5822434,1080,64,1047,33,1016,1.09919665899176,0.566773277292624,0.0315186246418337
"United States","Wisconsin","WI",2020-05-10,2020-05-16,7,2020,"20",5822434,1022,54,1044,-22,968,0.927447181024293,-0.377848851528416,-0.0210727969348659
"United States","Wisconsin","WI",2020-05-17,2020-05-23,7,2020,"21",5822434,1078,55,1035,43,1023,0.944622128821039,0.738522755260085,0.0415458937198068
"United States","Wisconsin","WI",2020-05-24,2020-05-30,7,2020,"22",5822434,1139,81,1020,119,1058,1.39117077153644,2.04381878781279,0.116666666666667
"United States","Wisconsin","WI",2020-05-31,2020-06-06,7,2020,"23",5822434,1043,57,1006,37,986,0.978972024414532,0.635473068479608,0.036779324055666
"United States","Wisconsin","WI",2020-06-07,2020-06-13,7,2020,"24",5822434,1026,46,998,28,980,0.790047598650324,0.480898538308893,0.0280561122244489
"United States","Wisconsin","WI",2020-06-14,2020-06-20,7,2020,"25",5822434,1085,52,1003,82,1033,0.893097285430801,1.40834571933319,0.081754735792622
"United States","Wisconsin","WI",2020-06-21,2020-06-27,7,2020,"26",5822434,1034,34,1010,24,1000,0.58394822508937,0.412198747121908,0.0237623762376238
"United States","Wisconsin","WI",2020-06-28,2020-07-04,7,2020,"27",5822434,1066,19,1011,55,1047,0.326324008138177,0.944622128821039,0.0544015825914936
"United States","Wisconsin","WI",2020-07-05,2020-07-11,7,2020,"28",5822434,1049,25,1007,42,1024,0.429373694918654,0.721347807463339,0.0417080436941411
"United States","Wisconsin","WI",2020-07-12,2020-07-18,7,2020,"29",5822434,1039,22,999,40,1017,0.377848851528416,0.686997911869847,0.04004004004004
"United States","Wisconsin","WI",2020-07-19,2020-07-25,7,2020,"30",5822434,1101,48,989,112,1053,0.824397494243816,1.92359415323557,0.11324570273003
"United States","Wisconsin","WI",2020-07-26,2020-08-01,7,2020,"31",5822434,1057,56,980,77,1001,0.961797076617786,1.32247098034946,0.0785714285714285
"United States","Wisconsin","WI",2020-08-02,2020-08-08,7,2020,"32",5822434,1099,49,982,117,1050,0.841572442040562,2.0094688922193,0.119144602851324
"United States","Wisconsin","WI",2020-08-09,2020-08-15,7,2020,"33",5822434,1126,42,985,141,1084,0.721347807463339,2.42166763934121,0.143147208121827
"United States","Wisconsin","WI",2020-08-16,2020-08-22,7,2020,"34",5822434,1061,43,978,83,1018,0.738522755260085,1.42552066712993,0.0848670756646217
"United States","Wisconsin","WI",2020-08-23,2020-08-29,7,2020,"35",5822434,1082,38,986,96,1044,0.652648016276354,1.64879498848763,0.0973630831643002
"United States","Wisconsin","WI",2020-08-30,2020-09-05,7,2020,"36",5822434,1039,49,993,46,990,0.841572442040562,0.790047598650324,0.0463242698892246
"United States","Wisconsin","WI",2020-09-06,2020-09-12,7,2020,"37",5822434,1066,41,993,73,1025,0.704172859666593,1.25377118916247,0.0735146022155087
"United States","Wisconsin","WI",2020-09-13,2020-09-19,7,2020,"38",5822434,1140,32,990,150,1108,0.549598329495878,2.57624216951193,0.151515151515152
"United States","Wisconsin","WI",2020-09-20,2020-09-26,7,2020,"39",5822434,1102,40,1003,99,1062,0.686997911869847,1.70031983187787,0.0987038883349951
"United States","Wisconsin","WI",2020-09-27,2020-10-03,7,2020,"40",5822434,1157,91,1010,147,1066,1.5629202495039,2.52471732612169,0.145544554455445
"United States","Wisconsin","WI",2020-10-04,2020-10-10,7,2020,"41",5822434,1163,86,1019,144,1077,1.47704551052017,2.47319248273145,0.141315014720314
"United States","Wisconsin","WI",2020-10-11,2020-10-17,7,2020,"42",5822434,1244,116,1024,220,1128,1.99229394442256,3.77848851528416,0.21484375
"United States","Wisconsin","WI",2020-10-18,2020-10-24,7,2020,"43",5822434,1387,196,1024,363,1191,3.36628976816225,6.23450605021886,0.3544921875
"United States","Wisconsin","WI",2020-10-25,2020-10-31,7,2020,"44",5822434,1454,259,1038,416,1195,4.44831147935726,7.14477828344641,0.400770712909441
"United States","Wisconsin","WI",2020-11-01,2020-11-07,7,2020,"45",5822434,1601,272,1044,557,1329,4.67158580071496,9.56644592278762,0.533524904214559
"United States","Wisconsin","WI",2020-11-08,2020-11-14,7,2020,"46",5822434,1716,323,1041,675,1393,5.54750813834901,11.5930897628037,0.648414985590778
"United States","Wisconsin","WI",2020-11-15,2020-11-21,7,2020,"47",5822434,1657,327,1029,628,1330,5.616207929536,10.7858672163566,0.610301263362488
"United States","Wisconsin","WI",2020-11-22,2020-11-28,7,2020,"48",5822434,1636,333,1039,597,1303,5.71925761631648,10.2534438346575,0.574590952839269
"United States","Wisconsin","WI",2020-11-29,2020-12-05,7,2020,"49",5822434,1652,415,1042,610,1237,7.12760333564966,10.4767181560152,0.585412667946257
"United States","Wisconsin","WI",2020-12-06,2020-12-12,7,2020,"50",5822434,1569,340,1046,523,1229,5.8394822508937,8.98249769769825,0.5
"United States","Wisconsin","WI",2020-12-13,2020-12-19,7,2020,"51",5822434,1500,360,1066,434,1140,6.18298120682862,7.45392734378784,0.407129455909944
"United States","Wisconsin","WI",2020-12-20,2020-12-26,7,2020,"52",5822434,1404,283,1083,321,1121,4.86051022647917,5.51315824275552,0.296398891966759
"United States","Wisconsin","WI",2020-12-27,2021-01-02,7,2020,"53",5822434,1403,187,1097,306,1216,3.21171523799153,5.25553402580433,0.27894257064722
"United States","Wisconsin","WI",2021-01-03,2021-01-09,7,2021,"1",5822434,1378,286,1104,274,1092,4.91203506986941,4.70593569630845,0.248188405797102
"United States","Wisconsin","WI",2021-01-10,2021-01-16,7,2021,"2",5822434,1257,294,1133,124,963,5.04943465224337,2.12969352679653,0.109443954104148
"United States","Wisconsin","WI",2021-01-17,2021-01-23,7,2021,"3",5822434,1276,235,1130,146,1041,4.03611273223535,2.50754237832494,0.129203539823009
"United States","Wisconsin","WI",2021-01-24,2021-01-30,7,2021,"4",5822434,1197,208,1130,67,989,3.5723891417232,1.15072150238199,0.05929203539823
"United States","Wisconsin","WI",2021-01-31,2021-02-06,7,2021,"5",5822434,1164,162,1119,45,1002,2.78234154307288,0.772872650853578,0.0402144772117963
"United States","Wisconsin","WI",2021-02-07,2021-02-13,7,2021,"6",5822434,1151,110,1107,44,1041,1.88924425764208,0.755697703056832,0.0397470641373081
"United States","Wisconsin","WI",2021-02-14,2021-02-20,7,2021,"7",5822434,1132,121,1090,42,1011,2.07816868340629,0.721347807463339,0.0385321100917431
"United States","Wisconsin","WI",2021-02-21,2021-02-27,7,2021,"8",5822434,1111,130,1087,24,981,2.232743213577,0.412198747121908,0.0220791168353265
"United States","Wisconsin","WI",2021-02-28,2021-03-06,7,2021,"9",5822434,1081,71,1076,5,1010,1.21942129356898,0.0858747389837309,0.00464684014869898
"United States","Wisconsin","WI",2021-03-07,2021-03-13,7,2021,"10",5822434,1061,65,1078,-17,996,1.1163716067885,-0.291974112544685,-0.0157699443413729
"United States","Wisconsin","WI",2021-03-14,2021-03-20,7,2021,"11",5822434,1000,55,1080,-80,945,0.944622128821039,-1.37399582373969,-0.0740740740740741
"United States","Wisconsin","WI",2021-03-21,2021-03-27,7,2021,"12",5822434,1032,29,1079,-47,1003,0.498073486105639,-0.80722254644707,-0.0435588507877664
"United States","Wisconsin","WI",2021-03-28,2021-04-03,7,2021,"13",5822434,985,5,1075,-90,980,0.0858747389837309,-1.54574530170716,-0.0837209302325581
"United States","Wisconsin","WI",2021-04-04,2021-04-10,7,2021,"14",5822434,1065,36,1072,-7,1029,0.618298120682862,-0.120224634577223,-0.00652985074626866
"United States","Wisconsin","WI",2021-04-11,2021-04-17,7,2021,"15",5822434,990,35,1060,-70,955,0.601123172886116,-1.20224634577223,-0.0660377358490566
"United States","Wisconsin","WI",2021-04-18,2021-04-24,7,2021,"16",5822434,1077,46,1053,24,1031,0.790047598650324,0.412198747121908,0.0227920227920229
"United States","Wisconsin","WI",2021-04-25,2021-05-01,7,2021,"17",5822434,1025,84,1049,-24,941,1.44269561492668,-0.412198747121908,-0.0228789323164919
"United States","Wisconsin","WI",2021-05-02,2021-05-08,7,2021,"18",5822434,1024,63,1043,-19,961,1.08202171119501,-0.326324008138177,-0.0182166826462129
"United States","Wisconsin","WI",2021-05-09,2021-05-15,7,2021,"19",5822434,1003,54,1038,-35,949,0.927447181024293,-0.601123172886116,-0.0337186897880539
"United States","Wisconsin","WI",2021-05-16,2021-05-22,7,2021,"20",5822434,1028,31,1035,-7,997,0.532423381699131,-0.120224634577223,-0.00676328502415457
"United States","Wisconsin","WI",2021-05-23,2021-05-29,7,2021,"21",5822434,1021,64,1012,9,957,1.09919665899176,0.154574530170716,0.00889328063241113
"United States","Wisconsin","WI",2021-05-30,2021-06-05,7,2021,"22",5822434,1053,97,999,54,956,1.66596993628438,0.927447181024293,0.0540540540540539
"United States","Wisconsin","WI",2021-06-06,2021-06-12,7,2021,"23",5822434,1054,56,990,64,998,0.961797076617786,1.09919665899176,0.0646464646464646
"United States","Wisconsin","WI",2021-06-13,2021-06-19,7,2021,"24",5822434,1036,29,996,40,1007,0.498073486105639,0.686997911869847,0.0401606425702812
"United States","Wisconsin","WI",2021-06-20,2021-06-26,7,2021,"25",5822434,939,45,1000,-61,894,0.772872650853578,-1.04767181560152,-0.0610000000000001
"United States","Wisconsin","WI",2021-06-27,2021-07-03,7,2021,"26",5822434,1022,35,1013,9,987,0.601123172886116,0.154574530170716,0.00888450148075015
"United States","Wisconsin","WI",2021-07-04,2021-07-10,7,2021,"27",5822434,849,41,1014,-165,808,0.704172859666593,-2.83386638646312,-0.162721893491124
"United States","Wyoming","WY",2019-12-29,2020-01-04,7,2020,"1",578759,144,0,92,52,144,0,8.98474148998115,0.565217391304348
"United States","Wyoming","WY",2020-01-05,2020-01-11,7,2020,"2",578759,81,0,92,-11,81,0,-1.9006183921114,-0.119565217391304
"United States","Wyoming","WY",2020-01-12,2020-01-18,7,2020,"3",578759,103,0,93,10,103,0,1.72783490191945,0.10752688172043
"United States","Wyoming","WY",2020-01-19,2020-01-25,7,2020,"4",578759,96,0,94,2,96,0,0.34556698038389,0.0212765957446808
"United States","Wyoming","WY",2020-01-26,2020-02-01,7,2020,"5",578759,94,0,95,-1,94,0,-0.172783490191945,-0.0105263157894737
"United States","Wyoming","WY",2020-02-02,2020-02-08,7,2020,"6",578759,97,0,95,2,97,0,0.34556698038389,0.0210526315789474
"United States","Wyoming","WY",2020-02-09,2020-02-15,7,2020,"7",578759,75,0,95,-20,75,0,-3.4556698038389,-0.210526315789474
"United States","Wyoming","WY",2020-02-16,2020-02-22,7,2020,"8",578759,101,0,95,6,101,0,1.03670094115167,0.0631578947368421
"United States","Wyoming","WY",2020-02-23,2020-02-29,7,2020,"9",578759,100,0,94,6,100,0,1.03670094115167,0.0638297872340425
"United States","Wyoming","WY",2020-03-01,2020-03-07,7,2020,"10",578759,80,0,94,-14,80,0,-2.41896886268723,-0.148936170212766
"United States","Wyoming","WY",2020-03-08,2020-03-14,7,2020,"11",578759,85,0,95,-10,85,0,-1.72783490191945,-0.105263157894737
"United States","Wyoming","WY",2020-03-15,2020-03-21,7,2020,"12",578759,117,0,96,21,117,0,3.62845329403085,0.21875
"United States","Wyoming","WY",2020-03-22,2020-03-28,7,2020,"13",578759,88,0,92,-4,88,0,-0.691133960767781,-0.0434782608695652
"United States","Wyoming","WY",2020-03-29,2020-04-04,7,2020,"14",578759,123,0,94,29,123,0,5.01072121556641,0.308510638297872
"United States","Wyoming","WY",2020-04-05,2020-04-11,7,2020,"15",578759,102,0,93,9,102,0,1.55505141172751,0.096774193548387
"United States","Wyoming","WY",2020-04-12,2020-04-18,7,2020,"16",578759,89,2,90,-1,87,0.34556698038389,-0.172783490191945,-0.0111111111111111
"United States","Wyoming","WY",2020-04-19,2020-04-25,7,2020,"17",578759,98,5,89,9,93,0.863917450959726,1.55505141172751,0.101123595505618
"United States","Wyoming","WY",2020-04-26,2020-05-02,7,2020,"18",578759,68,0,89,-21,68,0,-3.62845329403085,-0.235955056179775
"United States","Wyoming","WY",2020-05-03,2020-05-09,7,2020,"19",578759,83,0,90,-7,83,0,-1.20948443134362,-0.0777777777777777
"United States","Wyoming","WY",2020-05-10,2020-05-16,7,2020,"20",578759,101,0,91,10,101,0,1.72783490191945,0.10989010989011
"United States","Wyoming","WY",2020-05-17,2020-05-23,7,2020,"21",578759,96,5,91,5,91,0.863917450959726,0.863917450959726,0.054945054945055
"United States","Wyoming","WY",2020-05-24,2020-05-30,7,2020,"22",578759,84,3,90,-6,81,0.518350470575835,-1.03670094115167,-0.0666666666666667
"United States","Wyoming","WY",2020-05-31,2020-06-06,7,2020,"23",578759,105,2,91,14,103,0.34556698038389,2.41896886268723,0.153846153846154
"United States","Wyoming","WY",2020-06-07,2020-06-13,7,2020,"24",578759,96,1,91,5,95,0.172783490191945,0.863917450959726,0.054945054945055
"United States","Wyoming","WY",2020-06-14,2020-06-20,7,2020,"25",578759,93,2,91,2,91,0.34556698038389,0.34556698038389,0.0219780219780219
"United States","Wyoming","WY",2020-06-21,2020-06-27,7,2020,"26",578759,89,0,94,-5,89,0,-0.863917450959726,-0.0531914893617021
"United States","Wyoming","WY",2020-06-28,2020-07-04,7,2020,"27",578759,102,0,95,7,102,0,1.20948443134362,0.0736842105263158
"United States","Wyoming","WY",2020-07-05,2020-07-11,7,2020,"28",578759,104,1,96,8,103,0.172783490191945,1.38226792153556,0.0833333333333333
"United States","Wyoming","WY",2020-07-12,2020-07-18,7,2020,"29",578759,101,3,96,5,98,0.518350470575835,0.863917450959726,0.0520833333333333
"United States","Wyoming","WY",2020-07-19,2020-07-25,7,2020,"30",578759,95,1,97,-2,94,0.172783490191945,-0.34556698038389,-0.020618556701031
"United States","Wyoming","WY",2020-07-26,2020-08-01,7,2020,"31",578759,90,0,97,-7,90,0,-1.20948443134362,-0.0721649484536082
"United States","Wyoming","WY",2020-08-02,2020-08-08,7,2020,"32",578759,106,2,99,7,104,0.34556698038389,1.20948443134362,0.0707070707070707
"United States","Wyoming","WY",2020-08-09,2020-08-15,7,2020,"33",578759,113,1,97,16,112,0.172783490191945,2.76453584307112,0.164948453608248
"United States","Wyoming","WY",2020-08-16,2020-08-22,7,2020,"34",578759,100,9,99,1,91,1.55505141172751,0.172783490191945,0.0101010101010102
"United States","Wyoming","WY",2020-08-23,2020-08-29,7,2020,"35",578759,89,0,98,-9,89,0,-1.55505141172751,-0.0918367346938775
"United States","Wyoming","WY",2020-08-30,2020-09-05,7,2020,"36",578759,107,5,96,11,102,0.863917450959726,1.9006183921114,0.114583333333333
"United States","Wyoming","WY",2020-09-06,2020-09-12,7,2020,"37",578759,121,0,95,26,121,0,4.49237074499058,0.273684210526316
"United States","Wyoming","WY",2020-09-13,2020-09-19,7,2020,"38",578759,94,7,94,0,87,1.20948443134362,0,0
"United States","Wyoming","WY",2020-09-20,2020-09-26,7,2020,"39",578759,112,1,91,21,111,0.172783490191945,3.62845329403085,0.230769230769231
"United States","Wyoming","WY",2020-09-27,2020-10-03,7,2020,"40",578759,119,3,94,25,116,0.518350470575835,4.31958725479863,0.265957446808511
"United States","Wyoming","WY",2020-10-04,2020-10-10,7,2020,"41",578759,102,0,96,6,102,0,1.03670094115167,0.0625
"United States","Wyoming","WY",2020-10-11,2020-10-17,7,2020,"42",578759,107,4,96,11,103,0.691133960767781,1.9006183921114,0.114583333333333
"United States","Wyoming","WY",2020-10-18,2020-10-24,7,2020,"43",578759,131,11,97,34,120,1.9006183921114,5.87463866652614,0.350515463917526
"United States","Wyoming","WY",2020-10-25,2020-10-31,7,2020,"44",578759,114,19,98,16,95,3.28288631364696,2.76453584307112,0.163265306122449
"United States","Wyoming","WY",2020-11-01,2020-11-07,7,2020,"45",578759,136,17,95,41,119,2.93731933326307,7.08412309786975,0.431578947368421
"United States","Wyoming","WY",2020-11-08,2020-11-14,7,2020,"46",578759,132,19,98,34,113,3.28288631364696,5.87463866652614,0.346938775510204
"United States","Wyoming","WY",2020-11-15,2020-11-21,7,2020,"47",578759,135,41,99,36,94,7.08412309786975,6.22020564691003,0.363636363636364
"United States","Wyoming","WY",2020-11-22,2020-11-28,7,2020,"48",578759,138,51,99,39,87,8.8119579997892,6.73855611748586,0.393939393939394
"United States","Wyoming","WY",2020-11-29,2020-12-05,7,2020,"49",578759,123,42,104,19,81,7.2569065880617,3.28288631364696,0.182692307692308
"United States","Wyoming","WY",2020-12-06,2020-12-12,7,2020,"50",578759,143,64,103,40,79,11.0581433722845,6.91133960767781,0.388349514563107
"United States","Wyoming","WY",2020-12-13,2020-12-19,7,2020,"51",578759,165,30,103,62,135,5.18350470575835,10.7125763919006,0.601941747572815
"United States","Wyoming","WY",2020-12-20,2020-12-26,7,2020,"52",578759,130,0,104,26,130,0,4.49237074499058,0.25
"United States","Wyoming","WY",2020-12-27,2021-01-02,7,2020,"53",578759,129,87,103,26,42,15.0321636466992,4.49237074499058,0.25242718446602
"United States","Wyoming","WY",2021-01-03,2021-01-09,7,2021,"1",578759,127,51,101,26,76,8.8119579997892,4.49237074499058,0.257425742574257
"United States","Wyoming","WY",2021-01-10,2021-01-16,7,2021,"2",578759,110,33,101,9,77,5.70185517633419,1.55505141172751,0.0891089108910892
"United States","Wyoming","WY",2021-01-17,2021-01-23,7,2021,"3",578759,111,49,102,9,62,8.46639101940531,1.55505141172751,0.088235294117647
"United States","Wyoming","WY",2021-01-24,2021-01-30,7,2021,"4",578759,121,25,101,20,96,4.31958725479863,3.4556698038389,0.198019801980198
"United States","Wyoming","WY",2021-01-31,2021-02-06,7,2021,"5",578759,114,28,102,12,86,4.83793772537446,2.07340188230334,0.117647058823529
"United States","Wyoming","WY",2021-02-07,2021-02-13,7,2021,"6",578759,104,23,99,5,81,3.97402027441474,0.863917450959726,0.0505050505050506
"United States","Wyoming","WY",2021-02-14,2021-02-20,7,2021,"7",578759,112,15,103,9,97,2.59175235287918,1.55505141172751,0.087378640776699
"United States","Wyoming","WY",2021-02-21,2021-02-27,7,2021,"8",578759,104,9,102,2,95,1.55505141172751,0.34556698038389,0.0196078431372548
"United States","Wyoming","WY",2021-02-28,2021-03-06,7,2021,"9",578759,88,13,102,-14,75,2.24618537249529,-2.41896886268723,-0.137254901960784
"United States","Wyoming","WY",2021-03-07,2021-03-13,7,2021,"10",578759,106,9,101,5,97,1.55505141172751,0.863917450959726,0.0495049504950495
"United States","Wyoming","WY",2021-03-14,2021-03-20,7,2021,"11",578759,86,1,100,-14,85,0.172783490191945,-2.41896886268723,-0.14
"United States","Wyoming","WY",2021-03-21,2021-03-27,7,2021,"12",578759,111,2,98,13,109,0.34556698038389,2.24618537249529,0.13265306122449
"United States","Wyoming","WY",2021-03-28,2021-04-03,7,2021,"13",578759,88,4,95,-7,84,0.691133960767781,-1.20948443134362,-0.0736842105263158
"United States","Wyoming","WY",2021-04-04,2021-04-10,7,2021,"14",578759,93,1,96,-3,92,0.172783490191945,-0.518350470575835,-0.03125
"United States","Wyoming","WY",2021-04-11,2021-04-17,7,2021,"15",578759,78,2,93,-15,76,0.34556698038389,-2.59175235287918,-0.161290322580645
"United States","Wyoming","WY",2021-04-18,2021-04-24,7,2021,"16",578759,100,2,96,4,98,0.34556698038389,0.691133960767781,0.0416666666666667
"United States","Wyoming","WY",2021-04-25,2021-05-01,7,2021,"17",578759,90,2,96,-6,88,0.34556698038389,-1.03670094115167,-0.0625
"United States","Wyoming","WY",2021-05-02,2021-05-08,7,2021,"18",578759,93,3,98,-5,90,0.518350470575835,-0.863917450959726,-0.0510204081632653
"United States","Wyoming","WY",2021-05-09,2021-05-15,7,2021,"19",578759,91,2,99,-8,89,0.34556698038389,-1.38226792153556,-0.0808080808080808
"United States","Wyoming","WY",2021-05-16,2021-05-22,7,2021,"20",578759,98,1,98,0,97,0.172783490191945,0,0
"United States","Wyoming","WY",2021-05-23,2021-05-29,7,2021,"21",578759,100,6,94,6,94,1.03670094115167,1.03670094115167,0.0638297872340425
"United States","Wyoming","WY",2021-05-30,2021-06-05,7,2021,"22",578759,107,1,93,14,106,0.172783490191945,2.41896886268723,0.150537634408602
"United States","Wyoming","WY",2021-06-06,2021-06-12,7,2021,"23",578759,108,5,91,17,103,0.863917450959726,2.93731933326307,0.186813186813187
"United States","Wyoming","WY",2021-06-13,2021-06-19,7,2021,"24",578759,101,9,90,11,92,1.55505141172751,1.9006183921114,0.122222222222222
"United States","Wyoming","WY",2021-06-20,2021-06-26,7,2021,"25",578759,95,6,93,2,89,1.03670094115167,0.34556698038389,0.021505376344086
"United States","Wyoming","WY",2021-06-27,2021-07-03,7,2021,"26",578759,93,7,92,1,86,1.20948443134362,0.172783490191945,0.0108695652173914
"United States","Wyoming","WY",2021-07-04,2021-07-10,7,2021,"27",578759,57,4,93,-36,53,0.691133960767781,-6.22020564691003,-0.387096774193548
"United States","United States","USA",2019-12-29,2020-01-04,7,2020,"1",328300544,60175,0,62863,-2688,60175,0,-0.818761969520221,-0.0427596519415236
"United States","United States","USA",2020-01-05,2020-01-11,7,2020,"2",328300544,60744,0,63198,-2454,60744,0,-0.747485815923595,-0.038830342732365
"United States","United States","USA",2020-01-12,2020-01-18,7,2020,"3",328300544,59371,0,63165,-3794,59371,0,-1.15564840489573,-0.0600649093643632
"United States","United States","USA",2020-01-19,2020-01-25,7,2020,"4",328300544,59162,0,62623,-3461,59162,0,-1.05421695554668,-0.055267234083324
"United States","United States","USA",2020-01-26,2020-02-01,7,2020,"5",328300544,58836,0,62061,-3225,58836,0,-0.982331604056069,-0.0519650021752791
"United States","United States","USA",2020-02-02,2020-02-08,7,2020,"6",328300544,59491,1,61433,-1942,59490,0.00030459894699413,-0.5915311550626,-0.0316116745071867
"United States","United States","USA",2020-02-09,2020-02-15,7,2020,"7",328300544,58824,0,60798,-1974,58824,0,-0.601278321366412,-0.0324681732951742
"United States","United States","USA",2020-02-16,2020-02-22,7,2020,"8",328300544,58912,1,60213,-1301,58911,0.00030459894699413,-0.396283230039363,-0.021606629797552
"United States","United States","USA",2020-02-23,2020-02-29,7,2020,"9",328300544,59334,1,59528,-194,59333,0.00030459894699413,-0.0590921957168612,-0.00325897056847202
"United States","United States","USA",2020-03-01,2020-03-07,7,2020,"10",328300544,59695,19,59346,349,59676,0.00578737999288847,0.106305032500951,0.00588076702726381
"United States","United States","USA",2020-03-08,2020-03-14,7,2020,"11",328300544,58673,39,58959,-286,58634,0.0118793589327711,-0.0871152988403211,-0.00485082854186802
"United States","United States","USA",2020-03-15,2020-03-21,7,2020,"12",328300544,59242,284,58508,734,58958,0.0865061009463329,0.223575627093691,0.0125452929513912
"United States","United States","USA",2020-03-22,2020-03-28,7,2020,"13",328300544,63048,1988,58036,5012,61060,0.60554270662433,1.52664992233458,0.0863601902267559
"United States","United States","USA",2020-03-29,2020-04-04,7,2020,"14",328300544,72295,7056,57385,14910,65239,2.14925016999058,4.54157029968248,0.259823995817722
"United States","United States","USA",2020-04-05,2020-04-11,7,2020,"15",328300544,79095,13519,56859,22236,65576,4.11787316441364,6.77306218536147,0.391072653405793
"United States","United States","USA",2020-04-12,2020-04-18,7,2020,"16",328300544,76810,14155,56354,20456,62655,4.31159809470191,6.23087605971192,0.362991092025411
"United States","United States","USA",2020-04-19,2020-04-25,7,2020,"17",328300544,73931,15605,55646,18285,58326,4.7532665678434,5.56959174578766,0.328595047263056
"United States","United States","USA",2020-04-26,2020-05-02,7,2020,"18",328300544,69321,12860,54854,14467,56461,3.91714245834451,4.40663296616408,0.263736464068254
"United States","United States","USA",2020-05-03,2020-05-09,7,2020,"19",328300544,66814,12666,54166,12648,54148,3.85805026262765,3.85256748158175,0.233504412361998
"United States","United States","USA",2020-05-10,2020-05-16,7,2020,"20",328300544,64492,9576,53730,10762,54916,2.91683951641579,3.27809386755083,0.200297785222408
"United States","United States","USA",2020-05-17,2020-05-23,7,2020,"21",328300544,61630,8548,53418,8212,53082,2.60371179890582,2.50136655271579,0.15373095211352
"United States","United States","USA",2020-05-24,2020-05-30,7,2020,"22",328300544,59694,6656,53199,6495,53038,2.02741059119293,1.97837016072687,0.122088761066937
"United States","United States","USA",2020-05-31,2020-06-06,7,2020,"23",328300544,58908,6391,53058,5850,52517,1.94669187023948,1.78190383991566,0.110256700214859
"United States","United States","USA",2020-06-07,2020-06-13,7,2020,"24",328300544,58034,5207,52841,5193,52827,1.58604671699843,1.58178233174052,0.0982759599553378
"United States","United States","USA",2020-06-14,2020-06-20,7,2020,"25",328300544,58011,4306,52866,5145,53705,1.31160306575672,1.5671615822848,0.0973215299057997
"United States","United States","USA",2020-06-21,2020-06-27,7,2020,"26",328300544,58510,5858,52772,5738,52652,1.78434063149161,1.74778875785232,0.108731903282044
"United States","United States","USA",2020-06-28,2020-07-04,7,2020,"27",328300544,59825,4079,52538,7287,55746,1.24245910478906,2.21961252674622,0.138699607902851
"United States","United States","USA",2020-07-05,2020-07-11,7,2020,"28",328300544,61945,4858,52299,9646,57087,1.47974168449748,2.93816144270538,0.184439473030077
"United States","United States","USA",2020-07-12,2020-07-18,7,2020,"29",328300544,63194,5326,51981,11213,57868,1.62229399169074,3.41546799264518,0.215713433754641
"United States","United States","USA",2020-07-19,2020-07-25,7,2020,"30",328300544,64249,6221,51698,12551,58028,1.89491004925048,3.82302138372332,0.2427753491431
"United States","United States","USA",2020-07-26,2020-08-01,7,2020,"31",328300544,64252,8026,51475,12777,56226,2.44471114857489,3.891860745744,0.24821758135017
"United States","United States","USA",2020-08-02,2020-08-08,7,2020,"32",328300544,63719,7128,51374,12345,56591,2.17118129417416,3.76027400064253,0.240296648109939
"United States","United States","USA",2020-08-09,2020-08-15,7,2020,"33",328300544,63644,7482,51278,12366,56162,2.27900932141008,3.76667057852941,0.241156051328055
"United States","United States","USA",2020-08-16,2020-08-22,7,2020,"34",328300544,62583,6875,51248,11335,55708,2.09411776058464,3.45262906417846,0.221179363097096
"United States","United States","USA",2020-08-23,2020-08-29,7,2020,"35",328300544,61125,6690,51260,9865,54435,2.03776695539073,3.00486861209709,0.192450253609052
"United States","United States","USA",2020-08-30,2020-09-05,7,2020,"36",328300544,60247,5713,51428,8819,54534,1.74017378417746,2.68625811354123,0.171482460916232
"United States","United States","USA",2020-09-06,2020-09-12,7,2020,"37",328300544,59665,5018,51471,8194,54647,1.52847751601654,2.4958837716699,0.159196440714189
"United States","United States","USA",2020-09-13,2020-09-19,7,2020,"38",328300544,59740,5484,51660,8080,54256,1.67042062531581,2.46115949171257,0.156407278358498
"United States","United States","USA",2020-09-20,2020-09-26,7,2020,"39",328300544,60626,5119,51945,8681,55507,1.55924200966295,2.64422345885604,0.167119068245259
"United States","United States","USA",2020-09-27,2020-10-03,7,2020,"40",328300544,59802,4872,52300,7502,54930,1.4840060697554,2.28510130034996,0.143441682600382
"United States","United States","USA",2020-10-04,2020-10-10,7,2020,"41",328300544,61799,4860,52585,9214,56939,1.48035088239147,2.80657469760391,0.175221070647523
"United States","United States","USA",2020-10-11,2020-10-17,7,2020,"42",328300544,60643,4696,52968,7675,55947,1.43039665508443,2.33779691817995,0.144898806826763
"United States","United States","USA",2020-10-18,2020-10-24,7,2020,"43",328300544,62191,5390,53235,8956,56801,1.64178832429836,2.72798816927943,0.168235183619799
"United States","United States","USA",2020-10-25,2020-10-31,7,2020,"44",328300544,63425,5607,53591,9834,57818,1.70788629579609,2.99542604474027,0.183500960982254
"United States","United States","USA",2020-11-01,2020-11-07,7,2020,"45",328300544,67590,6501,53994,13596,61089,1.98019775440884,4.14132728333219,0.251805756195133
"United States","United States","USA",2020-11-08,2020-11-14,7,2020,"46",328300544,68823,7640,54283,14540,61183,2.32713595503515,4.42886868929465,0.26785549803806
"United States","United States","USA",2020-11-15,2020-11-21,7,2020,"47",328300544,71677,9373,54719,16958,62304,2.85500593017598,5.16538894312645,0.309910634331768
"United States","United States","USA",2020-11-22,2020-11-28,7,2020,"48",328300544,73327,10520,55212,18115,62807,3.20438092237825,5.51780992479866,0.328098963993335
"United States","United States","USA",2020-11-29,2020-12-05,7,2020,"49",328300544,77451,14514,55785,21666,62937,4.4209491166728,6.59944078557482,0.388383974186609
"United States","United States","USA",2020-12-06,2020-12-12,7,2020,"50",328300544,82026,16360,56450,25576,65666,4.98323877282396,7.79042266832187,0.453073516386183
"United States","United States","USA",2020-12-13,2020-12-19,7,2020,"51",328300544,82956,17350,57346,25610,65606,5.28479173034815,7.80077903251967,0.446587381857497
"United States","United States","USA",2020-12-20,2020-12-26,7,2020,"52",328300544,84371,13916,58225,26146,70455,4.23879894637031,7.96404406810852,0.449051094890511
"United States","United States","USA",2020-12-27,2021-01-02,7,2020,"53",328300544,86983,19700,59238,27745,67283,6.00059925578436,8.45109778435213,0.468364900908201
"United States","United States","USA",2021-01-03,2021-01-09,7,2021,"1",328300544,86909,21036,60040,26869,65873,6.40754344896852,8.18426910678528,0.447518321119254
"United States","United States","USA",2021-01-10,2021-01-16,7,2021,"2",328300544,87228,23481,60548,26680,63747,7.15228787436916,8.12669990580338,0.440642135165489
"United States","United States","USA",2021-01-17,2021-01-23,7,2021,"3",328300544,83456,21264,60668,22788,62192,6.47699200888318,6.94120080410223,0.375618118283115
"United States","United States","USA",2021-01-24,2021-01-30,7,2021,"4",328300544,79403,21666,60566,18837,57737,6.59944078557482,5.73773036452842,0.311016081629957
"United States","United States","USA",2021-01-31,2021-02-06,7,2021,"5",328300544,75452,22297,60240,15212,53155,6.79164272112811,4.6335591816747,0.252523240371846
"United States","United States","USA",2021-02-07,2021-02-13,7,2021,"6",317812460,69273,21040,57706,11567,48233,6.62025648711193,3.63956781304295,0.200447093889717
"United States","United States","USA",2021-02-14,2021-02-20,7,2021,"7",317812460,67340,12850,57219,10121,54490,4.04326501232834,3.18458250504087,0.176881804994844
"United States","United States","USA",2021-02-21,2021-02-27,7,2021,"8",317812460,64759,14094,56938,7821,50665,4.43469082363857,2.46088526548015,0.137359935368295
"United States","United States","USA",2021-02-28,2021-03-06,7,2021,"9",317812460,61798,11906,56606,5192,49892,3.74623449313472,1.63366785556488,0.0917217256121259
"United States","United States","USA",2021-03-07,2021-03-13,7,2021,"10",317812460,59980,9271,56239,3741,50709,2.91712917737712,1.17710929269419,0.0665196749586585
"United States","United States","USA",2021-03-14,2021-03-20,7,2021,"11",317812460,58508,7022,55781,2727,51486,2.20947913747623,0.85805320534003,0.0488876140621359
"United States","United States","USA",2021-03-21,2021-03-27,7,2021,"12",317812460,59025,6938,55319,3706,52087,2.18304845568358,1.16609650861392,0.0669932572895389
"United States","United States","USA",2021-03-28,2021-04-03,7,2021,"13",317812460,56992,9573,54893,2099,47419,3.01215377144118,0.660452393842582,0.0382380267065017
"United States","United States","USA",2021-04-04,2021-04-10,7,2021,"14",317812460,59112,6723,54346,4766,52389,2.11539849633334,1.49962654075929,0.0876973466308468
"United States","United States","USA",2021-04-11,2021-04-17,7,2021,"15",317812460,57385,5026,53872,3513,52359,1.58143579392702,1.10536887068556,0.0652101277101278
"United States","United States","USA",2021-04-18,2021-04-24,7,2021,"16",317812460,58456,4670,53397,5059,53786,1.46942004728197,1.59181927605985,0.0947431503642526
"United States","United States","USA",2021-04-25,2021-05-01,7,2021,"17",317812460,57913,4644,52848,5065,53269,1.4612391219652,1.59370718190218,0.0958409022101121
"United States","United States","USA",2021-05-02,2021-05-08,7,2021,"18",317080915,56993,4438,52318,4675,52555,1.3996427378797,1.47438706615313,0.0893573913375894
"United States","United States","USA",2021-05-09,2021-05-15,7,2021,"19",317080915,56484,4064,52008,4476,52420,1.28169177258745,1.41162706055645,0.0860636825103831
"United States","United States","USA",2021-05-16,2021-05-22,7,2021,"20",317080915,56716,3919,51701,5015,52797,1.23596212026826,1.58161521641881,0.0970000580259569
"United States","United States","USA",2021-05-23,2021-05-29,7,2021,"21",317080915,55240,4107,51368,3872,51133,1.29525297982693,1.22113940537859,0.0753776670300577
"United States","United States","USA",2021-05-30,2021-06-05,7,2021,"22",317080915,55107,2883,51175,3932,52224,0.909231638870476,1.24006202013136,0.0768343917928676
"United States","United States","USA",2021-06-06,2021-06-12,7,2021,"23",315288768,54057,2616,50775,3282,51441,0.829715570457619,1.04095049779889,0.0646381093057606
"United States","United States","USA",2021-06-13,2021-06-19,7,2021,"24",315288768,53840,2135,50792,3048,51705,0.677157011822254,0.966732820624933,0.0600094503071349
"United States","United States","USA",2021-06-20,2021-06-26,7,2021,"25",311723481,52443,2097,50157,2286,50346,0.672711594671304,0.733342253418503,0.0455768885698906
"United States","United States","USA",2021-06-27,2021-07-03,7,2021,"26",311723481,49873,1661,49926,-53,48212,0.532844043275649,-0.017002248220114,-0.00106157112526539
"United States","United States","USA",2021-07-04,2021-07-10,7,2021,"27",311723481,43118,1551,49769,-6651,41567,0.497556358290507,-2.1336217530562,-0.133637404810223
